AA.ASV1	ATHYLFIVVVAVNSTLLTINAGDYIFYTDWAWTSFVVFSISQSTMLVVGAIYYMLFTGVPGTATYYATIMTIYTWVGGTLVGLSLPVFNMINLLLIADPLETAFKYPRPTLPPYMTPIEPQVGKFYNSPVALGSGAGAVLSVPIAALGAKLNT
AA.ASV2	CTHYLFIVVVAVNSTLLTINAGDYIFYTDWMWTSYVIFTLSQSLMLAVGAAYYLTFTGVPGTATYYALIMTVYTWIGGVLCGMSMSLFNMINLITIDDPLETAFKYPRTTLPPYMTPIEPQVGKFYDSPVALGAGASAVLTVTMTALGTKLTT
AA.ASV3	TTHYLFIVVLAVNSTLLTINAGDYIFYTDWAWTSFVVFSVSQSTMLVVGAIYYMLFTGVPGTATYYATIMTIYTWVGGTLVGLSLPIFNMINLLLVRDPLEMAFKYPRPTLPPYMTPIEPQVGKFYNSPVALGSGAGAVLSVPIAALGAKLNT
AA.ASV4	TTHYLFIVVVAVNGALLTINAGDYIFYTDWAWTSFVVFSISQSTMLVVGAIYYMLFTGVPGTATYYATIMTIYTWVGGTLVGLSLPIFNMINLLLVRDPLEMAFKYPRPTLPPYMTPIEPQVGKFYNSPVALGSGAGAVLSVPIAALGAKLNT
AA.ASV5	TTHYLFIVVVAVNSTLLTINAGDYIFYADWAWTSFVVFSISQSTMLVVGAIYYMLFTGVPGTATYYATIMTIYTWVGGTLVGLSLPIFNMINLLLVRDPLEMAFKYPRPTLPPYMTPIEPQVGKFYNSPVALGSGAGAVLSVPIAALGAKLNT
AA.ASV6	TTHYLFIVVVAVNSTLLTINAGDYIFYIDWAWTSFVVFSIAQSTMLVVGAIYYMLFTGVPGTATYYATIMTIYTWVGGTLVGLSLPIFNMINLLLVRDPLEMAFKYPRPTLPPYMTPIEPQVGKFYNSPVALGSGAGAVLSVPIAALGAKLNT
AA.ASV7	TTHYLFIVVVAVNSTLLTINAGDYIFYSDWAWTSFVVFSISQSTMLVVGAIYYMLFTGVPGTATYYATIMTIYTWVGGTLVGLSLPIFNMINLLLVRDPLEMAFKYPRPTLPPYMTPIEPQVGKFYNSPVALGAGAGAVLSVPIAALGAKLNT
AA.ASV8	TTHYLFIVVVAVNSTLLTINAGDYIFYSDWAWTSFVVFSISQSTMLVVGAIYYMLFTGVPGTATYYATIMTIYTWVGGTLVGLSLPIFNMINLLLVRDPLEMAFKYPRPTLPPYMTPIEPQVGKFYNSPVALGSGAGAVLSVPIAALGAKLNT
AA.ASV9	TTHYLFIVVVAVNSTLLTINAGDYIFYTDWAWTPFVVFSISQSTMLVVGAIYYMLFTGVPGTATYYATIMTIYTWVGGTLVGLSLPIFNMINLLLVRDPLEMAFKYPRPTLPPYMTPIEPQVGKFYNSPVALGSGAGAVLSVPIAALGAKLNT
AA.ASV10	TTHYLFIVVVAVNSTLLTINAGDYIFYTDWAWTSFVAFSVSQSTMLVVGAIYYMLFTGVPGTATYYATIMTIYTWVGGTLVGLSLPIFNMINLLLVRDPLEMAFKYPRPTLPPYMTPIEPQVGKFYNSPVALGSGAGAVLSVPIAALGAKLNT
AA.ASV11	TTHYLFIVVVAVNSTLLTINAGDYIFYTDWAWTSFVGFSISQSTMLVVGAIYYMLFTGVPGTATYYATIMTIYTWVGGTLVGLSLPIFNMINLLLVRDPLEMAFKYPRPTLPPYMTPIEPQVGKFYNSPVALGAGAGAVLSVPIAALGAKLNT
AA.ASV12	TTHYLFIVVVAVNSTLLTINAGDYIFYTDWAWTSFVGFSISQSTMLVVGAIYYMLFTGVPGTATYYATIMTIYTWVGGTLVGLSLPIFNMINLLLVRDPLEMAFKYPRPTLPPYMTPIEPQVGKFYNSPVALGSGAGAVLSVPIAALGAKLNT
AA.ASV13	TTHYLFIVVVAVNSTLLTINAGDYIFYTDWAWTSFVVFSIAQSTMLCVGAVYYLLFTGVPGTATYYATIMTIYTWVGGTLCGLSLPLFNMINLLLVRDPLEIAFKYPRPTLPPYMTPIEPQVGKFYNSPVALGSGASAVLTVPIAALGAKLNT
AA.ASV14	TTHYLFIVVVAVNSTLLTINAGDYIFYTDWAWTSFVVFSIAQSTMLVVGAIYYMLFTGVPGTATYYASIMTIYTWVGGTLVGLSLPIFNMINLLLVRDPLEMAFKYPRPTLPPYMTPIEPQVGKFYNSPVALGSGAGAVLSVPIAALGAKLNT
AA.ASV15	TTHYLFIVVVAVNSTLLTINAGDYIFYTDWAWTSFVVFSIAQSTMLVVGAIYYMLFTGVPGTATYYATIMTIYTWVGGTLVGLSIPMFNMINLLTIRDPLEMAFKYPRPTLPPYMTPIEPQVGKFYNSPVALGAGAGAVLSVPIAALGAKLNT
AA.ASV16	TTHYLFIVVVAVNSTLLTINAGDYIFYTDWAWTSFVVFSIAQSTMLVVGAIYYMLFTGVPGTATYYATIMTIYTWVGGTLVGLSLPIFNMINLLLVRDPLEMAFKYPRPTLPPYMTPIEPQVGKFYNSPVALGAGAGAVLSVPIAALGAKLNT
AA.ASV17	TTHYLFIVVVAVNSTLLTINAGDYIFYTDWAWTSFVVFSIAQSTMLVVGAIYYMLFTGVPGTATYYATIMTIYTWVGGTLVGLSLPIFNMINLLLVRDPLEMAFKYPRPTLPPYMTPIEPQVGKFYNSPVALGAGAGAVLSVPVAALGAKLNT
AA.ASV18	TTHYLFIVVVAVNSTLLTINAGDYIFYTDWAWTSFVVFSIAQSTMLVVGAIYYMLFTGVPGTATYYATIMTIYTWVGGTLVGLSLPIFNMINLLLVRDPLEMAFKYPRPTLPPYMTPIEPQVGKFYNSPVALGSGAGAVLSVPIAALGAKLNT
AA.ASV19	TTHYLFIVVVAVNSTLLTINAGDYIFYTDWAWTSFVVFSIAQSTMLVVGAIYYMLFTGVPGTATYYATIMTIYTWVGGTLVGLSLPIFNMINLLLVRDPLEMAFKYPRPTLPPYMTPIEPQVGKFYNSPVALGSGASAVLTVPIAALGAKLNT
AA.ASV20	TTHYLFIVVVAVNSTLLTINAGDYIFYTDWAWTSFVVFSIAQSTMLVVGAIYYMLFTGVPGTATYYATIMTIYTWVGGTLVGLSLPIFNMTNLLLVRDPLEMAFKYPRPTLPPYMTPIEPQVGKFYNSPVALGAGAGAVLCVPIAALGAKLNT
AA.ASV21	TTHYLFIVVVAVNSTLLTINAGDYIFYTDWAWTSFVVFSIAQSTMLVVGAIYYMLFTGVPGTATYYATIMTIYTWVGGTLVGLSLPMFNMINLLLVRDPLETAFKYPRPTLPPYMTPIEPQVGKFYNSPVALGSGAGAVLSVPIAALGAKLNT
AA.ASV22	TTHYLFIVVVAVNSTLLTINAGDYIFYTDWAWTSFVVFSIAQSTMLVVGAIYYMLFTGVPGTATYYATIMTIYTWVGGTLVGLSLPVFNMINLLLVRDPLEMAFKYPRPTLPPYMTPIEPQVGKFYNSPVALGAGAGAVLCVPIAALGAKLNT
AA.ASV23	TTHYLFIVVVAVNSTLLTINAGDYIFYTDWAWTSFVVFSIAQSTMLVVGAIYYMLFTGVPGTATYYATIMTIYTWVGGTMVGLSLPIFNMINLLLVRDPLEMAFKYPRPTLPPYMTPIEPQVGKFYNSPVALGAGVGAVLSVPIAALGAKLNT
AA.ASV24	TTHYLFIVVVAVNSTLLTINAGDYIFYTDWAWTSFVVFSIAQSTMPVVGAIYYMLFTGVPGTATYYATIMTIYTWVGGTLVGLSLPIFNMINLLLVRDPLEMAFKYPRPTLPPYMTPIEPQVGKFYNSPVALGSGAGAVLSVPIAALGAKLNT
AA.ASV25	TTHYLFIVVVAVNSTLLTINAGDYIFYTDWAWTSFVVFSIPQSTMLVVGAIYYMLFTGVPGTATYYATIMTIYTWVGGTLVGLSLPIFNMINLLLVRDPLEMAFKYPRPTLPPYMTPIEPQVGKFYNSPVALGSGAGAVLSVPIAALGAKLNT
AA.ASV26	TTHYLFIVVVAVNSTLLTINAGDYIFYTDWAWTSFVVFSISKSTMLVVGAIYYMLFTGVPGTATYYATIMTIYTWVGGTLVGLSLPIFNMINLLLVRDPLEMAFKYPRPTLPPYMTPIEPQVGKFYNSPVALGSGAGAVLSVPIAALGAKLNT
AA.ASV27	TTHYLFIVVVAVNSTLLTINAGDYIFYTDWAWTSFVVFSISKSTMLVVGAIYYMLFTGVPGTATYYATIVTIYTWVGGTLVGLSLPMFNMINLLLIRDPLEVAFKYPRPTLPPYMTPIEPQVGKFYNSPVALGAGAGAVLSVPIAALGAKLNT
AA.ASV28	TTHYLFIVVVAVNSTLLTINAGDYIFYTDWAWTSFVVFSISQSTMLAVGAIYYMLFTGVPGTATYYATIMTIYTWVGGTLIGLSIPLFNMINLLLVRDPLEVAFKYPRPTLPPYMTPIEPQVGKFYNSPVALGAGAGAVLTVPIAALGAKLNT
AA.ASV29	TTHYLFIVVVAVNSTLLTINAGDYIFYTDWAWTSFVVFSISQSTMLAVGAIYYMLFTGVPGTATYYATIMTIYTWVGGTLIGLSIQLFNMINLLLVRDPLEVAFKYPRPTLPPYMTPIEPQVGKFYNSPVALGSGAGAVLTVPIAALGAKLNT
AA.ASV30	TTHYLFIVVVAVNSTLLTINAGDYIFYTDWAWTSFVVFSISQSTMLAVGAIYYMLFTGVPGTATYYATIMTIYTWVGGTLIGLSLPLFNMVNLLLIRDPLEVAFKYPRPTLPAYMTPIEPQVGKFYNSPVALGAGAGAVLTVPIAALGAKLNT
AA.ASV31	TTHYLFIVVVAVNSTLLTINAGDYIFYTDWAWTSFVVFSISQSTMLAVGAIYYMLFTGVPGTATYYATIMTIYTWVGGTLIGLSLPMFNMINLLLIRDPLEIAFKYPRPTLPPYMTPIEPQVGKFYNSPVALGSGAGAVLTVPIAALGAKLNT
AA.ASV32	TTHYLFIVVVAVNSTLLTINAGDYIFYTDWAWTSFVVFSISQSTMLAVGAIYYMLFTGVPGTATYYATIMTIYTWVGGTLIGLSLPMFNMINLLLIRDPLEVAFKYPRPTLPPYMTPIEPQVGKFYNSPVALGSGAGAVLSVPIAALGAKLNT
AA.ASV33	TTHYLFIVVVAVNSTLLTINAGDYIFYTDWAWTSFVVFSISQSTMLAVGAIYYMLFTGVPGTATYYATIMTIYTWVGGTLIGLSLPMFNMINLLLIRDPLEVAFKYPRPTLPPYMTPIEPQVGKFYNSPVALGSGAGAVLTVPIAALGAKLNT
AA.ASV34	TTHYLFIVVVAVNSTLLTINAGDYIFYTDWAWTSFVVFSISQSTMLAVGAIYYMLFTGVPGTATYYATIMTIYTWVGGTLIGLSLPMFNMINLLLIRDPLEVAFKYPRPTLPPYMTPIEPQVGKFYNSPVALGSGASAVLTVPIAALGAKLNT
AA.ASV35	TTHYLFIVVVAVNSTLLTINAGDYIFYTDWAWTSFVVFSISQSTMLAVGAIYYMLFTGVPGTATYYATIMTIYTWVGGTLIGLSLPMFNMINLLLIRGPLEVAFKYPRPTLPPYMTPIEPQVGKFYNSPVALGSGAGAVLSVPIAALGAKLNT
AA.ASV36	TTHYLFIVVVAVNSTLLTINAGDYIFYTDWAWTSFVVFSISQSTMLAVGAIYYMLFTGVPGTATYYATIMTIYTWVGGTLIGLSLPMFNMINLLLVRDPLEVAFKYPRPTLPPYMTPIEPQVGKFYNSPVALGAGAGAVLTVPIAALGAKLNT
AA.ASV37	TTHYLFIVVVAVNSTLLTINAGDYIFYTDWAWTSFVVFSISQSTMLAVGAIYYMLFTGVPGTATYYATIMTIYTWVGGTLIGLSLPMFNMINLLLVRDPLEVAFKYPRPTLPPYMTPIEPQVGKFYNSPVALGSGAGAVLTVPIAALGAKLNT
AA.ASV38	TTHYLFIVVVAVNSTLLTINAGDYIFYTDWAWTSFVVFSISQSTMLAVGAIYYMLFTGVPGTATYYATIMTIYTWVGGTLIGLSLPMFNMINLLLVRDPLEVAFKYPRPTLPPYMTPIEPQVGKFYNSPVALGSGASAVLTVPIAALGAKLNT
AA.ASV39	TTHYLFIVVVAVNSTLLTINAGDYIFYTDWAWTSFVVFSISQSTMLAVGAIYYMLFTGVPGTATYYATIMTIYTWVGGTLIGLSLPVFNMINLLLIRDPLEVAFKYPRPTLPPYMTPIEPQVGKFYNSPVALGSGAGAVLSVPIAALGAKLNT
AA.ASV40	TTHYLFIVVVAVNSTLLTINAGDYIFYTDWAWTSFVVFSISQSTMLAVGAIYYMLFTGVPGTATYYATIMTIYTWVGGTLIGMSLPLFNMINLLLVRDPLEVAFKYPRPTLPPYMTPIEPQVGKFYNSPVALGAGAGAVLTVPIAALGAKLNT
AA.ASV41	TTHYLFIVVVAVNSTLLTINAGDYIFYTDWAWTSFVVFSISQSTMLAVGAIYYMLFTGVPGTATYYATIMTIYTWVGGTLVGLSIPLFNMVNLLLIRDPLEIAFKYPRPTLPSYMTPIEPQVGKFYNSPVALGSGAGAVLTVPIAALGAKLNT
AA.ASV42	TTHYLFIVVVAVNSTLLTINAGDYIFYTDWAWTSFVVFSISQSTMLAVGAIYYMLFTGVPGTATYYATIMTIYTWVGGTLVGLSIPLFNMVNLLLIRDPLEVAFKYPRPTLPAYMTPIEPQVGKFYNSPVALGSGAGAVLTVPIAALGAKLNT
AA.ASV43	TTHYLFIVVVAVNSTLLTINAGDYIFYTDWAWTSFVVFSISQSTMLAVGAIYYMLFTGVPGTATYYATIMTIYTWVGGTLVGLSIPLFNMVNLLLIRDPLEVAFKYPRPTLPSYMTPIEPQVGKFYNSPVALGSGAGAVLTVPIAALGAKLNT
AA.ASV44	TTHYLFIVVVAVNSTLLTINAGDYIFYTDWAWTSFVVFSISQSTMLAVGAIYYMLFTGVPGTATYYATIMTIYTWVGGTLVGLSLPLFNMVNLLLIRDPLEVAFKYPRPTLPSYMTPIEPQVGKFYNSPVALGAGAGAVLTVPIAALGAKLNT
AA.ASV45	TTHYLFIVVVAVNSTLLTINAGDYIFYTDWAWTSFVVFSISQSTMLAVGAIYYMLFTGVPGTATYYATIMTIYTWVGGTLVGLSLPMFNMINLLLVRDPLEVAFKYPRPTLPPYMTPIEPQVGKFYNSPVALGAGAGAVLTVPIAALGAKLNT
AA.ASV46	TTHYLFIVVVAVNSTLLTINAGDYIFYTDWAWTSFVVFSISQSTMLAVGAIYYMLFTGVPGTATYYATIMTIYTWVGGTLVGLSLPMFNMINLLLVRDPLEVAFKYPRPTLPPYMTPIEPQVGKFYNSPVALGSGAGAVLTVPIAALGAKLNT
AA.ASV47	TTHYLFIVVVAVNSTLLTINAGDYIFYTDWAWTSFVVFSISQSTMLAVGAIYYMLFTGVPGTATYYATIMTIYTWVGGTLVGLSLPMFNMINLLLVRDPLEVAFKYPRPTLPPYMTPIEPQVGKFYNSPVALGSGASAVLTVPIAALGAKLNT
AA.ASV48	TTHYLFIVVVAVNSTLLTINAGDYIFYTDWAWTSFVVFSISQSTMLAVGAIYYMLFTGVPGTATYYATIMTIYTWVGGTLVGMSLPLFNMINLLLVRDPLEVAFKYPRPTLPPYMTPIEPQVGKFYNSPVALGAGAGAVLTVPIAALGAKLNT
AA.ASV49	TTHYLFIVVVAVNSTLLTINAGDYIFYTDWAWTSFVVFSISQSTMLAVGAIYYMLFTGVQGTATYYATIMTIYTWVGGTLIGLSIPLFNMINLLLVRDPLEVAFKYPRPTLPPYMTPIEPQVGKFYNSPVALGAGAGAVLTVPIAALGAKLNT
AA.ASV50	TTHYLFIVVVAVNSTLLTINAGDYIFYTDWAWTSFVVFSISQSTMLTVGAIYYMLFTGVPGTATYYATIMTIYTWVGGTLVGLSLAMFNMINLLLVRDPLETAFKYPRPTLPPYMTPIEPQVGKFYNSPVALGSGAGAVLSVPIAALGAKLNT
AA.ASV51	TTHYLFIVVVAVNSTLLTINAGDYIFYTDWAWTSFVVFSISQSTMLTVGAIYYMLFTGVPGTATYYATIMTIYTWVGGTLVGLSLPIFNMINLLLVRDPLEMAFKYPRPTLPPYMTPIEPQVGKFYNSPVALGSGAGAVLSVPIAALGAKLNT
AA.ASV52	TTHYLFIVVVAVNSTLLTINAGDYIFYTDWAWTSFVVFSISQSTMLTVGAIYYMLFTGVPGTATYYATIMTIYTWVGGTLVGLSLPMFNMINLLLVRDPLETAFKYPRPTLPPYMTPIEPQVGKFYNSPVALGAGAGAVLCVPIAALGAKLNT
AA.ASV53	TTHYLFIVVVAVNSTLLTINAGDYIFYTDWAWTSFVVFSISQSTMLTVGAIYYMLFTGVPGTATYYATIMTIYTWVGGTLVGLSLPMFNMINLLLVRDPLETAFKYPRPTLPPYMTPIEPQVGKFYNSPVALGAGAGAVLSVPIAALGAKLNT
AA.ASV54	TTHYLFIVVVAVNSTLLTINAGDYIFYTDWAWTSFVVFSISQSTMLTVGAIYYMLFTGVPGTATYYATIMTIYTWVGGTLVGLSLPMFNMINLLLVRDPLETAFKYPRPTLPPYMTPIEPQVGKFYNSPVALGSGASAVLTVPIAALGAKLNT
AA.ASV55	TTHYLFIVVVAVNSTLLTINAGDYIFYTDWAWTSFVVFSISQSTMLTVGAIYYMLFTGVPGTATYYATIMTIYTWVGGTLVGLSLPMFNMINLLLVRDPLETAFKYPRPTLPSYMTPIEPQVGKFYNSPVALGSGASAVLTVPIAALGAKLNT
AA.ASV56	TTHYLFIVVVAVNSTLLTINAGDYIFYTDWAWTSFVVFSISQSTMLTVGAIYYMLFTGVPGTATYYATIMTIYTWVGGTLVGLSLPMFNMVNLLLVRDPLETAFKYPRPTLPPYMAPIEPQVGKFYNSPVALGSGAGAVLSVPIAALGAKLNT
AA.ASV57	TTHYLFIVVVAVNSTLLTINAGDYIFYTDWAWTSFVVFSISQSTMLVGGAIYYMLFTGVPGTATYYATIMTIYTWVGGTLVGLSLPIFNMINLLLVRDPLEMAFKYPRPTLPPYMTPIEPQVGKFYNSPVALGSGAGAVLSVPIAALGAKLNT
AA.ASV58	TTHYLFIVVVAVNSTLLTINAGDYIFYTDWAWTSFVVFSISQSTMLVVEAIYYMLFTGVPGTATYYVTIMTIYTWVGGTLVGLSLPIFNMINLLLVRDPLEMAFKYPRPTLPPYMTPIEPQVGKFYNSPVALGSGAGAVLSVPIAALGAKLNT
AA.ASV59	TTHYLFIVVVAVNSTLLTINAGDYIFYTDWAWTSFVVFSISQSTMLVVGAIYYMLFTGIPGTATYYATIMTIYTWVGGTLVGLSLPMFNMINLLLVRDPLEMAFKYPRPTLPPYMTPIEPQVGKFYNSPVALGSGAGAVLSVPIAALGAKLNT
AA.ASV60	TTHYLFIVVVAVNSTLLTINAGDYIFYTDWAWTSFVVFSISQSTMLVVGAIYYMLFTGVPGTATYYASIMTIYTWVGGTLVGLSLPIFNMINLLLIRDPLEMAFKYPRPTLPPYMTPIEPQVGKFYNSPVALGSGAGAVLSVPIAALGAKLNT
AA.ASV61	TTHYLFIVVVAVNSTLLTINAGDYIFYTDWAWTSFVVFSISQSTMLVVGAIYYMLFTGVPGTATYYASIMTIYTWVGGTLVGLSLPIFNMINLLLVRDPLEMAFKYPRPTLPPYMTPIEPQVGKFYNSPVALGSGAGAVLSVPIAALGAKLNT
AA.ASV62	TTHYLFIVVVAVNSTLLTINAGDYIFYTDWAWTSFVVFSISQSTMLVVGAIYYMLFTGVPGTATYYASIMTIYTWVGGTLVGLSLPMFNMINLLTIRDPLEMAFKYPRPTLPPYMTPIEPQVGKFYNSPVALGAGAGAVLSVPIAALGAKLNT
AA.ASV63	TTHYLFIVVVAVNSTLLTINAGDYIFYTDWAWTSFVVFSISQSTMLVVGAIYYMLFTGVPGTATYYATIMTIYAWVGGTLVGLSLPIFNMINLLLVRDPLEMAFKYPRPTLPPYMTPIEPQVGKFYNSPVALGSGAGAVLSVPIAALGAKLNT
AA.ASV64	TTHYLFIVVVAVNSTLLTINAGDYIFYTDWAWTSFVVFSISQSTMLVVGAIYYMLFTGVPGTATYYATIMTIYTFVGGTLVGLSLPIFNMINLLLVRDPLEMAFKYPRPTLPPYMTPIEPQVGKFYNSPVALGAGAGAVLSVPIAALGAKLNT
AA.ASV65	TTHYLFIVVVAVNSTLLTINAGDYIFYTDWAWTSFVVFSISQSTMLVVGAIYYMLFTGVPGTATYYATIMTIYTFVGGTLVGLSLPIFNMINLLLVRDPLEMAFKYPRPTLPPYMTPIEPQVGKFYNSPVALGSGAGAVLSVPIAALGAKLNT
AA.ASV66	TTHYLFIVVVAVNSTLLTINAGDYIFYTDWAWTSFVVFSISQSTMLVVGAIYYMLFTGVPGTATYYATIMTIYTFVGGTLVGLSLPIFNMINLLLVRDPLEVAFKYPRPTLPPYMTPIEPQVGKFYNSPVALGSGAGAVLSVPIAALGAKLNT
AA.ASV67	TTHYLFIVVVAVNSTLLTINAGDYIFYTDWAWTSFVVFSISQSTMLVVGAIYYMLFTGVPGTATYYATIMTIYTFVGGTLVGLSLPVFNMINLLLVRDPLEMAFKYPRPTLPPYMTPIEPQVGKFYNSPVALGAGAGAVLCVPIAALGAKLNT
AA.ASV68	TTHYLFIVVVAVNSTLLTINAGDYIFYTDWAWTSFVVFSISQSTMLVVGAIYYMLFTGVPGTATYYATIMTIYTFVGGVLVGLSLPIFNMINLLLVRDPLEMAFKYPRPTLPPYMTPIEPQVGKFYNSPVALGAGAGAVLSVPIAALGAKLNT
AA.ASV69	TTHYLFIVVVAVNSTLLTINAGDYIFYTDWAWTSFVVFSISQSTMLVVGAIYYMLFTGVPGTATYYATIMTIYTFVGGVLVGLSLPIFNMINLLLVRDPLEMAFKYPRPTLPPYMTPIEPQVGKFYNSPVALGSGAGAVLSVPIAALGAKLNT
AA.ASV70	TTHYLFIVVVAVNSTLLTINAGDYIFYTDWAWTSFVVFSISQSTMLVVGAIYYMLFTGVPGTATYYATIMTIYTRVGGTLVGLSLPIFNMINLLLVRDPLEMAFKYPRPTLPPYMTPIEPQVGKFYNSPVALGSGAGAVLSVPIAALGAKLNT
AA.ASV71	TTHYLFIVVVAVNSTLLTINAGDYIFYTDWAWTSFVVFSISQSTMLVVGAIYYMLFTGVPGTATYYATIMTIYTWAGGTLVGLSLPIFNMINLLLVRDPLEMAFKYPRPTLPPYMTPIEPQVGKFYNSPVALGSGAGAVLSVPIAALGAKLNT
AA.ASV72	TTHYLFIVVVAVNSTLLTINAGDYIFYTDWAWTSFVVFSISQSTMLVVGAIYYMLFTGVPGTATYYATIMTIYTWVGETLVGLSLPIFNMINLLLVRDPLEMAFKYQRPTLPPYMTPIEPQVGKFYNSPVALGAGAGAVLSVPIAALGAKLNT
AA.ASV73	TTHYLFIVVVAVNSTLLTINAGDYIFYTDWAWTSFVVFSISQSTMLVVGAIYYMLFTGVPGTATYYATIMTIYTWVGGMLVGLSLPIFNMINLLLVRDPLEMAFKYPRPTLPPYMTPIEPQVGKFYNSPVALGSGAGAVLSVPIAALGAKLNT
AA.ASV74	TTHYLFIVVVAVNSTLLTINAGDYIFYTDWAWTSFVVFSISQSTMLVVGAIYYMLFTGVPGTATYYATIMTIYTWVGGTLVGLSLPIFNMINLLLIRDPLEMAFKYPRPTLPPYMTPIEPQVGKFYNSPVALGSGAGAVLSVPIAALGAKLNT
AA.ASV75	TTHYLFIVVVAVNSTLLTINAGDYIFYTDWAWTSFVVFSISQSTMLVVGAIYYMLFTGVPGTATYYATIMTIYTWVGGTLVGLSLPIFNMINLLLVRDPLELAFKYPRPTLPPYMTPIEPQVGKFYNSPVALGSGASAVLTVPIAALGAKLNT
AA.ASV76	TTHYLFIVVVAVNSTLLTINAGDYIFYTDWAWTSFVVFSISQSTMLVVGAIYYMLFTGVPGTATYYATIMTIYTWVGGTLVGLSLPIFNMINLLLVRDPLEMAFKYPRPTLPPYMTPIEPQVGKFYDSPVALGAGAGAVLCVPIAALGAKLNT
AA.ASV77	TTHYLFIVVVAVNSTLLTINAGDYIFYTDWAWTSFVVFSISQSTMLVVGAIYYMLFTGVPGTATYYATIMTIYTWVGGTLVGLSLPIFNMINLLLVRDPLEMAFKYPRPTLPPYMTPIEPQVGKFYNSPVALGAGAGAVLCVPIAALGAKLNT
AA.ASV78	TTHYLFIVVVAVNSTLLTINAGDYIFYTDWAWTSFVVFSISQSTMLVVGAIYYMLFTGVPGTATYYATIMTIYTWVGGTLVGLSLPIFNMINLLLVRDPLEMAFKYPRPTLPPYMTPIEPQVGKFYNSPVALGAGAGAVLSVPIAALGAKLNT
AA.ASV79	TTHYLFIVVVAVNSTLLTINAGDYIFYTDWAWTSFVVFSISQSTMLVVGAIYYMLFTGVPGTATYYATIMTIYTWVGGTLVGLSLPIFNMINLLLVRDPLEMAFKYPRPTLPPYMTPIEPQVGKFYNSPVALGSGAAAVLSVPIAALGAKLNT
AA.ASV80	TTHYLFIVVVAVNSTLLTINAGDYIFYTDWAWTSFVVFSISQSTMLVVGAIYYMLFTGVPGTATYYATIMTIYTWVGGTLVGLSLPIFNMINLLLVRDPLEMAFKYPRPTLPPYMTPIEPQVGKFYNSPVALGSGAGAVLSVPIAALGAKLNT
AA.ASV81	TTHYLFIVVVAVNSTLLTINAGDYIFYTDWAWTSFVVFSISQSTMLVVGAIYYMLFTGVPGTATYYATIMTIYTWVGGTLVGLSLPIFNMINLLLVRDPLEMAFKYPRPTLPPYMTPIEPQVSKFYNSPVALGSGAGAVLSVPIAALGAKLNT
AA.ASV82	TTHYLFIVVVAVNSTLLTINAGDYIFYTDWAWTSFVVFSISQSTMLVVGAIYYMLFTGVPGTATYYATIMTIYTWVGGTLVGLSLPIFNMINLLLVRDPLEMAFKYPRPTLPPYMTPIKPQVGKFYNSPVALGSGAGAVLSVPIAALGAKLNT
AA.ASV83	TTHYLFIVVVAVNSTLLTINAGDYIFYTDWAWTSFVVFSISQSTMLVVGAIYYMLFTGVPGTATYYATIMTIYTWVGGTLVGLSLPIFNMINLLLVRDPLEMAFKYPRPTLPPYMTPTEPQVGKFYNSPVALGSGAAAVLSVPIAALGAKLNT
AA.ASV84	TTHYLFIVVVAVNSTLLTINAGDYIFYTDWAWTSFVVFSISQSTMLVVGAIYYMLFTGVPGTATYYATIMTIYTWVGGTLVGLSLPIFNMINLLLVRDPLEMAFKYPRPTLPPYMTPVEPQVGKFYNSPVALGSGAGAVLTVPIAALGAKLNT
AA.ASV85	TTHYLFIVVVAVNSTLLTINAGDYIFYTDWAWTSFVVFSISQSTMLVVGAIYYMLFTGVPGTATYYATIMTIYTWVGGTLVGLSLPIFNMINLLLVRDPLEMAFKYPRPTLPPYMTSIEPQVGKFYNSPVALGSGAGAVLTVPIAALGAKLNT
AA.ASV86	TTHYLFIVVVAVNSTLLTINAGDYIFYTDWAWTSFVVFSISQSTMLVVGAIYYMLFTGVPGTATYYATIMTIYTWVGGTLVGLSLPIFNMINLLLVRDPLEMAFKYPRPTLPPYTTPIEPQVGKFYNSPVALGAGAGAVLSVPIAALGAKLNT
AA.ASV87	TTHYLFIVVVAVNSTLLTINAGDYIFYTDWAWTSFVVFSISQSTMLVVGAIYYMLFTGVPGTATYYATIMTIYTWVGGTLVGLSLPIFNMINLLLVRDPLEMAFKYPRPTLPPYTTPIEPQVGKFYNSPVALGSGAGAVLSVPIAALGAKLNT
AA.ASV88	TTHYLFIVVVAVNSTLLTINAGDYIFYTDWAWTSFVVFSISQSTMLVVGAIYYMLFTGVPGTATYYATIMTIYTWVGGTLVGLSLPIFNMINLLLVRDPLEVAFKYPRPTLPPYMTPIEPQVGKFYNSPVALGAGAGAVLCVPIAALGAKLNT
AA.ASV89	TTHYLFIVVVAVNSTLLTINAGDYIFYTDWAWTSFVVFSISQSTMLVVGAIYYMLFTGVPGTATYYATIMTIYTWVGGTLVGLSLPIFNMINLLLVRDPLEVAFKYPRPTLPPYMTPIEPQVGKFYNSPVALGAGAGAVLSVPIAALGAKLNT
AA.ASV90	TTHYLFIVVVAVNSTLLTINAGDYIFYTDWAWTSFVVFSISQSTMLVVGAIYYMLFTGVPGTATYYATIMTIYTWVGGTLVGLSLPIFNMINLLLVRDPLEVAFKYPRPTLPPYMTPIEPQVGKFYNSPVALGSGAAAVLSVPIAALGAKLNT
AA.ASV91	TTHYLFIVVVAVNSTLLTINAGDYIFYTDWAWTSFVVFSISQSTMLVVGAIYYMLFTGVPGTATYYATIMTIYTWVGGTLVGLSLPIFNMINLLLVRDPLEVAFKYPRPTLPPYMTPIEPQVGKFYNSPVALGSGAGAVLSVPIAALGAKLNT
AA.ASV92	TTHYLFIVVVAVNSTLLTINAGDYIFYTDWAWTSFVVFSISQSTMLVVGAIYYMLFTGVPGTATYYATIMTIYTWVGGTLVGLSLPIFNMINLLLVRDPLEVAFKYPRPTLPPYMTPIEPQVGKFYNSPVALGSGASAVLTVPIAALGAKLNT
AA.ASV93	TTHYLFIVVVAVNSTLLTINAGDYIFYTDWAWTSFVVFSISQSTMLVVGAIYYMLFTGVPGTATYYATIMTIYTWVGGTLVGLSLPIFNMINLLLVREPLEMAFKYPRPTLPPYMTPIEPQVGKFYNSPVALGSGAAAVLSVPIAALGAKLNT
AA.ASV94	TTHYLFIVVVAVNSTLLTINAGDYIFYTDWAWTSFVVFSISQSTMLVVGAIYYMLFTGVPGTATYYATIMTIYTWVGGTLVGLSLPIFNMINLLLVRGPLEMAFKYPRPTLPPYMTPIEPQVGKFYNSPVALGSGAGAVLSVPIAALGAKLNT
AA.ASV95	TTHYLFIVVVAVNSTLLTINAGDYIFYTDWAWTSFVVFSISQSTMLVVGAIYYMLFTGVPGTATYYATIMTIYTWVGGTLVGLSLPIFNMTNLLLVRDPLEMAFKYPRPTLPPYMTPIEPQVGKFYNSPVALGAGAGAVLCVPIAALGAKLNT
AA.ASV96	TTHYLFIVVVAVNSTLLTINAGDYIFYTDWAWTSFVVFSISQSTMLVVGAIYYMLFTGVPGTATYYATIMTIYTWVGGTLVGLSLPLFNMINLLLIRDPLEMAFKYPRPTLPPYMTPIEPQVGKFYNSPVALGSGAGAVLSVPIAALGAKLNT
AA.ASV97	TTHYLFIVVVAVNSTLLTINAGDYIFYTDWAWTSFVVFSISQSTMLVVGAIYYMLFTGVPGTATYYATIMTIYTWVGGTLVGLSLPLFNMINLLLVRDPLEMQFKYPRPTLPPYMTPIEPQVGKFYNSPVALGSGAGAVLCVPIAALGAKLNT
AA.ASV98	TTHYLFIVVVAVNSTLLTINAGDYIFYTDWAWTSFVVFSISQSTMLVVGAIYYMLFTGVPGTATYYATIMTIYTWVGGTLVGLSLPLFNMINLLLVRDPLETAFKYPRPTLPPYMTPIEPQVGKFYNSPVALGSGAGAVLSVPIAALGAKLNT
AA.ASV99	TTHYLFIVVVAVNSTLLTINAGDYIFYTDWAWTSFVVFSISQSTMLVVGAIYYMLFTGVPGTATYYATIMTIYTWVGGTLVGLSLPLFNMINLLTIRDPLEMAFKHPRPTLPPYMTPIEPQVGKFYNSPVALGSGAGAVLSVPIAALGAKLNT
AA.ASV100	TTHYLFIVVVAVNSTLLTINAGDYIFYTDWAWTSFVVFSISQSTMLVVGAIYYMLFTGVPGTATYYATIMTIYTWVGGTLVGLSLPLFNMINLLTIRDPLEMAFKYPRPTLPAYMTPIEPQVGKFYNSPVALGSGAGAVLTVPIDALGAKLNT
AA.ASV101	TTHYLFIVVVAVNSTLLTINAGDYIFYTDWAWTSFVVFSISQSTMLVVGAIYYMLFTGVPGTATYYATIMTIYTWVGGTLVGLSLPLFNMINLLTIRDPLEMAFKYPRPTLPPYMTPIEPQVGKFYNSPVALGAGAGAVLSVPIAALGAKLNT
AA.ASV102	TTHYLFIVVVAVNSTLLTINAGDYIFYTDWAWTSFVVFSISQSTMLVVGAIYYMLFTGVPGTATYYATIMTIYTWVGGTLVGLSLPLFNMINLLTIRDPLEMAFKYPRPTLPPYMTPIEPQVGKFYNSPVALGSGAGAVLSVPIAALGAKLNT
AA.ASV103	TTHYLFIVVVAVNSTLLTINAGDYIFYTDWAWTSFVVFSISQSTMLVVGAIYYMLFTGVPGTATYYATIMTIYTWVGGTLVGLSLPLFNMINLLTIRDPLETAFKYPRPTLPPYMTPIEPQVGKFYNSPVALGSGASAVLTVPIAALGAKLNT
AA.ASV104	TTHYLFIVVVAVNSTLLTINAGDYIFYTDWAWTSFVVFSISQSTMLVVGAIYYMLFTGVPGTATYYATIMTIYTWVGGTLVGLSLPLFNMVNLLLVRDPLETAFKYPRPTLPPYMTPIEPQVGKFYNSPVALGSGAGAVLSVPIAALGAKLNT
AA.ASV105	TTHYLFIVVVAVNSTLLTINAGDYIFYTDWAWTSFVVFSISQSTMLVVGAIYYMLFTGVPGTATYYATIMTIYTWVGGTLVGLSLPLFNMVNLLLVRDPLETAFKYPRPTLPPYMTPIEPQVGKFYNSPVALGSGSAAVLSVPIAALGAKLNT
AA.ASV106	TTHYLFIVVVAVNSTLLTINAGDYIFYTDWAWTSFVVFSISQSTMLVVGAIYYMLFTGVPGTATYYATIMTIYTWVGGTLVGLSLPLFNMVNLLLVRDPLEVAFKYPRPTLPPYMTPIEPQVGKFYNSPVALGSGSAAVLSVPIAALGAKLNT
AA.ASV107	TTHYLFIVVVAVNSTLLTINAGDYIFYTDWAWTSFVVFSISQSTMLVVGAIYYMLFTGVPGTATYYATIMTIYTWVGGTLVGLSLPMFNMINLLLIRDPLEMAFKYPRPTLPPYMTPIEPQVGKFYNSPVALGAGAGAVLSVPIAALGAKLNT
AA.ASV108	TTHYLFIVVVAVNSTLLTINAGDYIFYTDWAWTSFVVFSISQSTMLVVGAIYYMLFTGVPGTATYYATIMTIYTWVGGTLVGLSLPMFNMINLLLIRDPLETAFKYPRPTLPPYMTPIEPQVGKFYNSPVALGSGAGAVLSVPIAALGAKLNT
AA.ASV109	TTHYLFIVVVAVNSTLLTINAGDYIFYTDWAWTSFVVFSISQSTMLVVGAIYYMLFTGVPGTATYYATIMTIYTWVGGTLVGLSLPMFNMINLLLIRDPLETAFKYPRPTLPPYMTPIEPQVGKFYNSPVALGSGASAVLTVPIAALGAKLNT
AA.ASV110	TTHYLFIVVVAVNSTLLTINAGDYIFYTDWAWTSFVVFSISQSTMLVVGAIYYMLFTGVPGTATYYATIMTIYTWVGGTLVGLSLPMFNMINLLLIRDPLEVAFKYPRPTLPPYMAPIEPQVGKFYNSPVALGAGAGAVLSVPIAALGAILNT
AA.ASV111	TTHYLFIVVVAVNSTLLTINAGDYIFYTDWAWTSFVVFSISQSTMLVVGAIYYMLFTGVPGTATYYATIMTIYTWVGGTLVGLSLPMFNMINLLLIRDPLEVAFKYPRPTLPPYMTPIEPQVGKFYNSPVALGAGAGAVLSVPIAALGAKLNT
AA.ASV112	TTHYLFIVVVAVNSTLLTINAGDYIFYTDWAWTSFVVFSISQSTMLVVGAIYYMLFTGVPGTATYYATIMTIYTWVGGTLVGLSLPMFNMINLLLVRDPLEMAFKYPRPTLPPYMTPIEPQVGKFYNSPVALGAGAGAVLSVPIAALGAKLNT
AA.ASV113	TTHYLFIVVVAVNSTLLTINAGDYIFYTDWAWTSFVVFSISQSTMLVVGAIYYMLFTGVPGTATYYATIMTIYTWVGGTLVGLSLPMFNMINLLLVRDPLEMAFKYPRPTLPPYMTPIEPQVGKFYNSPVALGSGAAAVLSVPIAALGAKLNT
AA.ASV114	TTHYLFIVVVAVNSTLLTINAGDYIFYTDWAWTSFVVFSISQSTMLVVGAIYYMLFTGVPGTATYYATIMTIYTWVGGTLVGLSLPMFNMINLLLVRDPLEMAFKYPRPTLPPYMTPIEPQVGKFYNSPVALGSGAGAVLSVPIAALGAKLNT
AA.ASV115	TTHYLFIVVVAVNSTLLTINAGDYIFYTDWAWTSFVVFSISQSTMLVVGAIYYMLFTGVPGTATYYATIMTIYTWVGGTLVGLSLPMFNMINLLLVRDPLETAFKYPRPTLPPYMTPIEPQVGKFYNSPVALGAGAGAVLCVPIAALGAKLNT
AA.ASV116	TTHYLFIVVVAVNSTLLTINAGDYIFYTDWAWTSFVVFSISQSTMLVVGAIYYMLFTGVPGTATYYATIMTIYTWVGGTLVGLSLPMFNMINLLLVRDPLETAFKYPRPTLPPYMTPIEPQVGKFYNSPVALGSGAGAVLSVPIAALGAKLNT
AA.ASV117	TTHYLFIVVVAVNSTLLTINAGDYIFYTDWAWTSFVVFSISQSTMLVVGAIYYMLFTGVPGTATYYATIMTIYTWVGGTLVGLSLPMFNMINLLLVRDPLETAFKYPRPTLPPYMTPIEPQVGKFYNSPVALGSGAGAVLSVPVAALGAKLNT
AA.ASV118	TTHYLFIVVVAVNSTLLTINAGDYIFYTDWAWTSFVVFSISQSTMLVVGAIYYMLFTGVPGTATYYATIMTIYTWVGGTLVGLSLPMFNMINLLLVRDPLEVAFKYPRPTLPPYMTPIEPQVGKFYNSPVALGSGAAAVLSVPIAALGAKLNT
AA.ASV119	TTHYLFIVVVAVNSTLLTINAGDYIFYTDWAWTSFVVFSISQSTMLVVGAIYYMLFTGVPGTATYYATIMTIYTWVGGTLVGLSLPMFNMINLLTIRDPLEMAFKYPRPTLPPYMTPIEPQVGKFYNSPVALGAGAGAVLSVPIAALGAKLNT
AA.ASV120	TTHYLFIVVVAVNSTLLTINAGDYIFYTDWAWTSFVVFSISQSTMLVVGAIYYMLFTGVPGTATYYATIMTIYTWVGGTLVGLSLPMFNMINLLTIRDPLEMAFKYPRPTLPPYMTPIEPQVGKFYNSPVALGSGAGAVLSVPIAALGAKLNT
AA.ASV121	TTHYLFIVVVAVNSTLLTINAGDYIFYTDWAWTSFVVFSISQSTMLVVGAIYYMLFTGVPGTATYYATIMTIYTWVGGTLVGLSLPVFNMINLLLIADPLETAFKYPRPTLPPYMTPIEPQVGKFYNSPVALGSGAGAVLSVPIAALGAKLNT
AA.ASV122	TTHYLFIVVVAVNSTLLTINAGDYIFYTDWAWTSFVVFSISQSTMLVVGAIYYMLFTGVPGTATYYATIMTIYTWVGGTLVGLSLPVFNMINLLLIRDPLETAFKYPRPTLPPYMTPIEPQVGKFYNSPVALGSGAGAVLSVPIAALGAKLNT
AA.ASV123	TTHYLFIVVVAVNSTLLTINAGDYIFYTDWAWTSFVVFSISQSTMLVVGAIYYMLFTGVPGTATYYATIMTIYTWVGGTLVGLSLPVFNMINLLLVRDPLEMAFKYPRPTLPPYMTPIEPQVGKFYNSPVALGSGAGAVLSVPIAALGAKLNT
AA.ASV124	TTHYLFIVVVAVNSTLLTINAGDYIFYTDWAWTSFVVFSISQSTMLVVGAIYYMLFTGVPGTATYYATIMTIYTWVGGTLVGMSLHVFNMINLLLVKDPLEMAFKYPRPTLPPYMTPIEPQVGKFYNSPVALGSGASAVLTVPIAALGAKLNT
AA.ASV125	TTHYLFIVVVAVNSTLLTINAGDYIFYTDWAWTSFVVFSISQSTMLVVGAIYYMLFTGVPGTATYYATIMTIYTWVGGTLVGMSLPVFNMINLLLIKDPLEMAFKYPRPTLPPYMTPIEPQVGKFYNSPVALGAGAGAVLSVPIAALGAKLNT
AA.ASV126	TTHYLFIVVVAVNSTLLTINAGDYIFYTDWAWTSFVVFSISQSTMLVVGAIYYMLFTGVPGTATYYATIMTIYTWVGGTLVGMSLPVFNMINLLLIRDPLEIAFKYPRPTLPPYMTPIEPQVGKFYNSPVALGAGAGAVLSVPIAALGAKLNT
AA.ASV127	TTHYLFIVVVAVNSTLLTINAGDYIFYTDWAWTSFVVFSISQSTMLVVGAIYYMLFTGVPGTATYYATIMTIYTWVGGTLVGMSLPVFNMINLLLIRDPLEMAFKYPRPTLPPYMTPIEPQVGKFYNSPVALGAGAGAVLCVPIAALGAKLNT
AA.ASV128	TTHYLFIVVVAVNSTLLTINAGDYIFYTDWAWTSFVVFSISQSTMLVVGAIYYMLFTGVPGTATYYATIMTIYTWVGGTLVGMSLPVFNMINLLLVEDPLEMAFKYPRPTLPPYMTPIEPQVGKFYNSPVALGSGAGAVLSVPIAALGAKLNT
AA.ASV129	TTHYLFIVVVAVNSTLLTINAGDYIFYTDWAWTSFVVFSISQSTMLVVGAIYYMLFTGVPGTATYYATIMTIYTWVGGTLVGMSLPVFNMINLLLVKDPLEMAFKYPRPTLPPYMTPIEPQVGKFYNSPVALGAGAGAVLCVPIAALGAKLNT
AA.ASV130	TTHYLFIVVVAVNSTLLTINAGDYIFYTDWAWTSFVVFSISQSTMLVVGAIYYMLFTGVPGTATYYATIMTIYTWVGGTLVGMSLPVFNMINLLLVKDPLEMAFKYPRPTLPPYMTPIEPQVGKFYNSPVALGAGAGAVLSVPIAALGAKLNT
AA.ASV131	TTHYLFIVVVAVNSTLLTINAGDYIFYTDWAWTSFVVFSISQSTMLVVGAIYYMLFTGVPGTATYYATIMTIYTWVGGTLVGMSLPVFNMINLLLVKDPLEMAFKYPRPTLPPYMTPIEPQVGKFYNSPVALGSGAGAVLSVPIAALGAKLNT
AA.ASV132	TTHYLFIVVVAVNSTLLTINAGDYIFYTDWAWTSFVVFSISQSTMLVVGAIYYMLFTGVPGTATYYATIMTIYTWVGGTLVGMSLPVFNMINLLLVKDPLEMAFKYPRPTLPPYMTPVEPQVGKFYNSPVALGAGAGAVLCVPIAALGAKLNT
AA.ASV133	TTHYLFIVVVAVNSTLLTINAGDYIFYTDWAWTSFVVFSISQSTMLVVGAIYYMLFTGVPGTATYYATIMTIYTWVGGTLVGMSLPVFNMINLLLVRDPLEMAFKCPRPTLPPYMTPIEPQVGKFYNSPVALGSGAGAVLSVPIAALGAKLNT
AA.ASV134	TTHYLFIVVVAVNSTLLTINAGDYIFYTDWAWTSFVVFSISQSTMLVVGAIYYMLFTGVPGTATYYATIMTIYTWVGGTLVGMSLPVFNMINLLLVRDPLEMAFKYPRPTLPPYMTPIEPQVGKFYNSPVALGAGAGAVLCVPIAALGAKLNT
AA.ASV135	TTHYLFIVVVAVNSTLLTINAGDYIFYTDWAWTSFVVFSISQSTMLVVGAIYYMLFTGVPGTATYYATIMTIYTWVGGTLVGMSLPVFNMINLLLVRDPLEMAFKYPRPTLPPYMTPIEPQVGKFYNSPVALGAGAGAVLSVPIAALGAKLNT
AA.ASV136	TTHYLFIVVVAVNSTLLTINAGDYIFYTDWAWTSFVVFSISQSTMLVVGAIYYMLFTGVPGTATYYATIMTIYTWVGGTLVGMSLPVFNMINLLLVRDPLEMAFKYPRPTLPPYMTPIEPQVGKFYNSPVALGSGAGAVLSVPIAALGAKLNT
AA.ASV137	TTHYLFIVVVAVNSTLLTINAGDYIFYTDWAWTSFVVFSISQSTMLVVGAIYYMLFTGVPGTATYYATIMTIYTWVGGTLVGMSLPVFNMINLLLVRDPLEMAFKYPRPTLPPYMTPIEPQVGKFYNSPVALGSGAGAVLTVPIAALGAKLNT
AA.ASV138	TTHYLFIVVVAVNSTLLTINAGDYIFYTDWAWTSFVVFSISQSTMLVVGAIYYMLFTGVPGTATYYATIMTIYTWVGGTLVGMSLPVFNMINLLLVRDPLEMAFKYPRPTLPPYMTPIEPQVGKFYNSPVALGSGASAVLTVPIAALGAKLNT
AA.ASV139	TTHYLFIVVVAVNSTLLTINAGDYIFYTDWAWTSFVVFSISQSTMLVVGAIYYMLFTGVPGTATYYATIMTIYTWVGGTLVGMSLPVFNMINLLLVRDPLEMAFKYPRPTLPPYMTPVEPQVGKFYNSPVALGAGAGAVLCVPIAALGAKLNT
AA.ASV140	TTHYLFIVVVAVNSTLLTINAGDYIFYTDWAWTSFVVFSISQSTMLVVGAIYYMLFTGVPGTATYYATIMTIYTWVGGTLVGMSVPVFNMINLLLVRDPLEMAFKYPRPTLPPYMTPIEPQVGKFYNSPVALGSGASAVLTVPIAALGAKLNT
AA.ASV141	TTHYLFIVVVAVNSTLLTINAGDYIFYTDWAWTSFVVFSISQSTMLVVGAIYYMLFTGVPGTATYYATIMTIYTWVGGVLAGMSLPLFNMINLLLVADPLEMAFKYPRPTLPPSMTPIEPQVGKFYNSPVALGAGAGAVLCVPIAALGAKLNT
AA.ASV142	TTHYLFIVVVAVNSTLLTINAGDYIFYTDWAWTSFVVFSISQSTMLVVGAIYYMLFTGVPGTATYYATIMTIYTWVGGVLVGMSIPLFNMINLLLVSDPLEMAFKYPRPTLPPYMTPIEPQVGKFYNSPVALGAGAGAVLCVPIAALGAKLNT
AA.ASV143	TTHYLFIVVVAVNSTLLTINAGDYIFYTDWAWTSFVVFSISQSTMLVVGAIYYMLFTGVPGTATYYATIMTIYTWVGGVLVGMSLPLFNMINLLLIADPLETAFKYPRPTLPPYMTPIEPQVGKFYNSPVALGAGAGAVLCVPIAALGAKLNT
AA.ASV144	TTHYLFIVVVAVNSTLLTINAGDYIFYTDWAWTSFVVFSISQSTMLVVGAIYYMLFTGVPGTATYYATIMTIYTWVGGVLVGMSLPLFNMINLLLVADPLEMAFKYPRPTLPPYMTPIEPQVGKFYNSPVALGAGAGAVLCVPIAALGAKLNT
AA.ASV145	TTHYLFIVVVAVNSTLLTINAGDYIFYTDWAWTSFVVFSISQSTMLVVGAIYYMLFTGVPGTATYYATIMTIYTWVGGVLVGMSLPLFNMINLLLVADPLETAFKYPLPTLPPYMTPIEPQVGKFYNSPVALGSGAGAVLTVPIAALGAKLNT
AA.ASV146	TTHYLFIVVVAVNSTLLTINAGDYIFYTDWAWTSFVVFSISQSTMLVVGAIYYMLFTGVPGTATYYATIMTIYTWVGGVLVGMSLPLFNMINLLLVADPLETAFKYPRPTLLPYMTPIEPQVGKFYNSPVALGAGAGAVLCVPIAALGAKLNT
AA.ASV147	TTHYLFIVVVAVNSTLLTINAGDYIFYTDWAWTSFVVFSISQSTMLVVGAIYYMLFTGVPGTATYYATIMTIYTWVGGVLVGMSLPLFNMINLLLVADPLETAFKYPRPTLPPYMTPIEPQVGKFYNSPVALGAGAGAVLCVPIAALGAKLNT
AA.ASV148	TTHYLFIVVVAVNSTLLTINAGDYIFYTDWAWTSFVVFSISQSTMLVVGAIYYMLFTGVPGTATYYATTMTIYTWVGGTLVGLSLPIFNMINLLLVRDPLEMAFKYPRPTLPPYMTPIEPQVGKFYNSPVALGSGAGAVLSVPIAALGAKLNT
AA.ASV149	TTHYLFIVVVAVNSTLLTINAGDYIFYTDWAWTSFVVFSISQSTMLVVGAIYYMLLTGVPGTATYYATIMTIYTWVGGTLVGMSLPVFNMINLLLVRDPLEMAFKYPRPTLPPYMTPIEPQVGKFYNSPVALGAGAGAVLCVPIAALGAKLNT
AA.ASV150	TTHYLFIVVVAVNSTLLTINAGDYIFYTDWAWTSFVVFSISQSTVLAVGAIYYMLFTGVPGTATYYATIMTIYTWVGGTLIGLSLPMFNMINLLLIRDPLEVAFKYPRPTLPPYMTPIEPQVGKFYNSPVALGSGAGAVLTVPIAALGAKLNT
AA.ASV151	TTHYLFIVVVAVNSTLLTINAGDYIFYTDWAWTSFVVFSIYQSTMLVVGAIYYMLFTGVPGTATYYATIMTIYTWVGGVLVGMSIPLFNMINLLLVSDPLEMAFKYPRPTLPPYMTPIEPQVGKFYNSPVALGAGAGAVLCVPIAALGAKLNT
AA.ASV152	TTHYLFIVVVAVNSTLLTINAGDYIFYTDWAWTSFVVFSTSQSTMLAVGAIYYMLFTGVPGTATYYATIMTIYTWVGGTLIGLSLPMFNMINLLLIRDPLEVAFKYPRPTLPPYMTPIEPQVGKFYNSPVALGSGAGAVLTVPIAALGAKLNT
AA.ASV153	TTHYLFIVVVAVNSTLLTINAGDYIFYTDWAWTSFVVFSVSQSTMLAVGAIYYMLFTGVPGTATYYATIMTIYTWVGGTLVGLSFPLFNMVNLLLVRDPLEIAFKYPRPTLPAYMTPIEPQVGKFYNSPVALGSGAGAVLTVPIAALGAKLNT
AA.ASV154	TTHYLFIVVVAVNSTLLTINAGDYIFYTDWAWTSFVVFSVSQSTMLAVGAIYYMLFTGVPGTATYYATIMTIYTWVGGTLVGLSFPLFNMVNLLLVRDPLEVAFKYPRPTLPAYMTPIEPQVGKFYNSPVALGSGAGAVLTVPIAALGAKLNT
AA.ASV155	TTHYLFIVVVAVNSTLLTINAGDYIFYTDWAWTSFVVFSVSQSTMLVVGAIYYMLFTGVPGTATYYATIMTIYTWVGGSLVGLSLPIFNMINLLLIRDPLEMAFKYPRPTLPPYMTPIEPQVGKFYNSPVALGSGAGAVLAVPIAALGAKLNT
AA.ASV156	TTHYLFIVVVAVNSTLLTINAGDYIFYTDWAWTSFVVFSVSQSTMLVVGAIYYMLFTGVPGTATYYATIMTIYTWVGGTLVGLSLPIFNMINLLLIRDPLEMAFKYPRPTLPPYMTPIEPQVGKFYNSPVALGSGAGAVLSVPIAALGAKLNT
AA.ASV157	TTHYLFIVVVAVNSTLLTINAGDYIFYTDWAWTSFVVFSVSQSTMLVVGAIYYMLFTGVPGTATYYATIMTIYTWVGGTLVGLSLPIFNMINLLLVRDPLELAFKYPRPTLPPYMTPIEPQVGKFYNSPVALGSGASAVLTVPIAALGAKLNT
AA.ASV158	TTHYLFIVVVAVNSTLLTINAGDYIFYTDWAWTSFVVFSVSQSTMLVVGAIYYMLFTGVPGTATYYATIMTIYTWVGGTLVGLSLPIFNMINLLLVRDPLEMAFKYPRPTLPPYMTPIEPQVGKFYNSPVALGAGAGAVLSVPIAALGAKLNT
AA.ASV159	TTHYLFIVVVAVNSTLLTINAGDYIFYTDWAWTSFVVFSVSQSTMLVVGAIYYMLFTGVPGTATYYATIMTIYTWVGGTLVGLSLPIFNMINLLLVRDPLEMAFKYPRPTLPPYMTPIEPQVGKFYNSPVALGSGAAAVLSVPIAALGAKLNT
AA.ASV160	TTHYLFIVVVAVNSTLLTINAGDYIFYTDWAWTSFVVFSVSQSTMLVVGAIYYMLFTGVPGTATYYATIMTIYTWVGGTLVGLSLPIFNMINLLLVRDPLEMAFKYPRPTLPPYMTPIEPQVGKFYNSPVALGSGAGAVLSVPIAALGAKLNT
AA.ASV161	TTHYLFIVVVAVNSTLLTINAGDYIFYTDWAWTSFVVFSVSQSTMLVVGAIYYMLFTGVPGTATYYATIMTIYTWVGGTLVGLSLPIFNMINLLLVRDPLEVAFKYPRPTLPPYMTPIEPQVGKFYNSPVALGSGAGAVLSVPIAALGAKLNT
AA.ASV162	TTHYLFIVVVAVNSTLLTINAGDYIFYTDWAWTSFVVFSVSQSTMLVVGAIYYMLFTGVPGTATYYATIMTIYTWVGGTLVGLSLPIFNMTNLLLVRDPLEMAFKYPRPTLPPYMTPIEPQVGKFYNSPVALGAGAGAVLCVPIAALGAKLNT
AA.ASV163	TTHYLFIVVVAVNSTLLTINAGDYIFYTDWAWTSFVVFSVSQSTMLVVGAIYYMLFTGVPGTATYYATIMTIYTWVGGTLVGLSLPIFNTINLLLVRDPLEVAFKYPRPTLPPYMTPIEPQVGKFYNSPVALGSGASAVLTVPIAALGAKLNT
AA.ASV164	TTHYLFIVVVAVNSTLLTINAGDYIFYTDWAWTSFVVFSVSQSTMLVVGAIYYMLFTGVPGTATYYATIMTIYTWVGGTLVGLSLPMFNMINLLLIRDPLEVAFKYPRPTLPPYMTPIEPQVGKFYNSPVALGAGAGAVLSVPIAALGAKLNT
AA.ASV165	TTHYLFIVVVAVNSTLLTINAGDYIFYTDWAWTSFVVFSVSQSTMLVVGAIYYMLFTGVPGTATYYATIMTIYTWVGGTLVGLSLPMFNMINLLLVRDPLEMAFKYPRPTLPPYMTPIEPQVGKFYNSPVALGSGAGAVLSVPIAALGAKLNT
AA.ASV166	TTHYLFIVVVAVNSTLLTINAGDYIFYTDWAWTSFVVFSVSQSTMLVVGAIYYMLFTGVPGTATYYATIMTIYTWVGGTLVGLSLPMFNMINLLLVRDPLETAFKYPRPTLPPYMTPIEPQVGKFYNSPVALGSGASAVLTVPIAALGAKLNT
AA.ASV167	TTHYLFIVVVAVNSTLLTINAGDYIFYTDWAWTSFVVFSVSQSTMLVVGAIYYMLFTGVPGTATYYATIMTIYTWVGGTLVGMSLPVFNMINLLLVRDPLEMAFKYPRPTLPPYMTPIEPQVGKFYNSPVALGAGAGAVLCVPIAALGAKLNT
AA.ASV168	TTHYLFIVVVAVNSTLLTINAGDYIFYTDWAWTSFVVFSVSQSTMLVVGAIYYMLFTGVPGTATYYATIMTIYTWVGGVLVGLSLPIFNMINLLLVRDPLEMAFKYPRPTLPPYMTPIEPQVGKFYNSPVALGSGASAVLTVPIAALGAKLNT
AA.ASV169	TTHYLFIVVVAVNSTLLTINAGDYIFYTDWAWTSFVVFTISQSTMLVVGAVYYMLFTGVPGTATYYATIMTIYTWVGGTLVGLSLPLFNMINLLTIRDPLEMAFKYPRPTLPPYMTPIEPQVGKFYNSPVALGAGAGAVLSVPIAALGAKLNT
AA.ASV170	TTHYLFIVVVAVNSTLLTINAGDYIFYTDWAWTSFVVLSISQSTMLVVGAIYYMLFTGVPGTATYYATIMTIYTWVGGTLVGLSLPIFNMINLLLVRDPLEMAFKYPRPTLPPYMTPIEPQVGKFYNSPVALGSGAGAVLSVPIAALGAKLNT
AA.ASV171	TTHYLFIVVVAVNSTLLTINAGDYIFYTDWEWTSFVVFSISQSTMLVVGAIYYMLFTGVPGTATYYATIMTIYTWVGGTLVGLSLPIFNMINLLLVRDPLEMAFKYPRPTLPPYMTPIEPQVGKFYNSPVALGSGAGAVLSVPIAALGAKLNT
AA.ASV172	TTHYLFIVVVAVNSTLLTINAGDYIFYTDWEWTSFVVFSVSQSTMLAVGAIYYMLFTGVPGTATYYATIMTIYTWVGGTLVGLSFPLFNMVNLLLVRDPLEVAFKYPRPTLPAYMTPIEPQVGKFYNSPVALGSGAGAVLTVPIAALGAKLNT
AA.ASV173	TTHYLFIVVVAVNSTLLTINAGDYIFYTDWMRTSFVVFSVSQSTMLAVGAIYYMLFTGVPGTSTYYATIMTIYTWVGGTLVGLSFPLFNMVNLLLVRDPLEVAFKYPRPTLPAYMTPIEPQVGKFYNSPVALGSGASAVLTVPIAALGAKLNT
AA.ASV174	TTHYLFIVVVAVNSTLLTINAGDYIFYTDWMWSSFVVFSISQSTMLVVGAIYYMLFTGVPGTATYYATIMTIYTWVGGTLVGLSMPLFNMVNLLLIRDPLEVAFKYPRPTLPSYMTPVEPQVGKFYNSPVALGSGAGAVLCVPIAALGAKLNT
AA.ASV175	TTHYLFIVVVAVNSTLLTINAGDYIFYTDWMWTSFVVFSIAQSTMLAVGAIYYMLFTGVPGTATYYATIMTIYTWVGGTLIGLSLPLFNMVNLLLIRDPLEIAFKYPRPTLPAYMTPIEPQVGKFYNSPVALGAGAGAVLTVPIAALGAKLNT
AA.ASV176	TTHYLFIVVVAVNSTLLTINAGDYIFYTDWMWTSFVVFSISQSTMLAVGAIYYMLFTGVPGTATYYATIMTIYTWVGGTLIGLSLPLFNMVNLLLIRDPLEVAFKYPRPTLPAYMTPIEPQVGKFYNSPVALGAGAGAVLTVPIAALGAKLNT
AA.ASV177	TTHYLFIVVVAVNSTLLTINAGDYIFYTDWMWTSFVVFSISQSTMLAVGAIYYMLFTGVPGTATYYATIMTIYTWVGGTLVGLSFPLFNMVNLLLIRDPLEVAFKYPRPTLPAYMTPIEPQVGKFYNSPVALGSGAGAVLTVPIAALGAKLNT
AA.ASV178	TTHYLFIVVVAVNSTLLTINAGDYIFYTDWMWTSFVVFSISQSTMLAVGAIYYMLFTGVPGTATYYATIMTIYTWVGGTLVGLSLPLFNMVNLLLIRDPLEVAFKYPRPTLPAYMTPIEPQVGKFYNSPVALGAGAGAVLTVPIAALGAKLNT
AA.ASV179	TTHYLFIVVVAVNSTLLTINAGDYIFYTDWMWTSFVVFSVSQSTMLAVGAIYYMLFTGVPGTATYYATIMTIYTWVGGSLIGLSFPLFNMVNLLLVRDPLEVAFKYPRPTLPAYMTPIEPQVGKFYNSPVALGSGAGAVLTVPIAALGAKLNT
AA.ASV180	TTHYLFIVVVAVNSTLLTINAGDYIFYTDWMWTSFVVFSVSQSTMLAVGAIYYMLFTGVPGTATYYATIMTIYTWVGGTLVGLSFPLFNMVNLLLVRDPLEIAFKYPRPTLPAYMTPIEPQVGKFYNSPVALGSGAGAVLTVPIAALGAKLNT
AA.ASV181	TTHYLFIVVVAVNSTLLTINAGDYIFYTDWMWTSFVVFSVSQSTMLAVGAIYYMLFTGVPGTATYYATIMTIYTWVGGTLVGLSFPLFNMVNLLLVRDPLEVAFKYPRPTLPAYMTPIEPQVGKFYNSPVALGSGAGAVLTVPIAALGAKLNT
AA.ASV182	TTHYLFIVVVAVNSTLLTINAGDYIFYTDWMWTSFVVFSVSQSTMLAVGAIYYMLFTGVPGTATYYATIMTIYTWVGGTLVGLSFPLFNMVNLLLVRDPLEVAFKYPRPTLPAYMTPIEPQVGKFYNSPVALGSGASAVLTVPIAALGAKLNT
AA.ASV183	TTHYLFIVVVAVNSTLLTINAGDYIFYTDWMWTSFVVFSVSQSTMLAVGAIYYMLFTGVPGTATYYATIMTIYTWVGGTLVGLSFPLFNMVNLLLVSDPLEVAFKYPRPTLPAYMTPIEPQVGKFYNSPVALGSGAGAVLTVPIAALGAKLNT
AA.ASV184	TTHYLFIVVVAVNSTLLTINAGDYIFYTDWMWTSFVVFSVSQSTMLVVGAIYYMLFTGVPGTATYYATIMTIYTWVGGTLVGLSFPLFNMINLLLVRDPLEVAFKYPRPTLPAYMMPIEPQVGKFYNSPVALGSGAGAVLSVPIAALGAKLNT
AA.ASV185	TTHYLFIVVVAVNSTLLTINAGDYIFYTDWMWTSFVVFSVSQSTMLVVGAIYYMLFTGVPGTATYYATIMTIYTWVGGTLVGLSFPLFNMINLLLVRDPLEVAFKYPRPTLPAYMTPIEPQVGKFYNSPVALGSGAGAVLSVPIAALGAKLNT
AA.ASV186	TTHYLFIVVVAVNSTLLTINAGDYIFYTDWMWTSFVVFSVSQSTMLVVGAIYYMLFTGVPGTATYYATIMTIYTWVGGTLVGLSFPLFNMVNLLLVRDPLEVAFKYPRPTLPAYMTPIEPQVGKFYNSPVALGSGAGAVLSVPIAALGAKLNT
AA.ASV187	TTHYLFIVVVAVNSTLLTINAGDYIFYTDWQWTSFVVFSISQSTMLAVGAVYYMLFTGVPGTATYYATIMTIYTWVGGTLVGLSFPLFNMVNLLLIRDPLEIAFKYPRPTLPAYMTPIEPQVGKFYNSPVALGSGASAVLTVPMTALGAKLNT
AA.ASV188	TTHYLFIVVVAVNSTLLTINAGDYIFYTDWQWTSFVVFSISQSTMLAVGAVYYMLFTGVPGTATYYATIMTIYTWVGGTLVGLSFPLFNMVNLLLIRDPLEVAFKYPRPTLPAYMTPIEPQVGKFYNSPVALGSGAGAVLTVPMTALGAKLNT
AA.ASV189	TTHYLFIVVVAVNSTLLTINAGDYIFYTDWQWTSFVVFSISQSTMLAVGAVYYMLFTGVPGTATYYATIMTIYTWVGGTLVGLSFPLFNMVNLLLIRDPLEVAFKYPRPTLPAYMTPIEPQVGKFYNSPVALGSGASAVLTVPMTALGAKLNT
AA.ASV190	TTHYLFIVVVAVNSTLLTINAGDYIFYTDWQWTSFVVFSVSQSTMLAVGAVYYMLFTGVPGTATYYATIMTIYTWVGGTLVGLSFPLFNMVNLLLIRDPLEIAFKYPRPTLPAYMTPIEPQVGKFYNSPVALGSGASAVLTVPMTALGAKLNT
AA.ASV191	TTHYLFIVVVAVNSTLLTINSGDYIFYTDWAWTSFVVFSISQSTMLAVGAIYYMLFTGVPGTATYYATIMTIYTWVGGTLIGLSLPMFNMINLLLVRDPLEVAFKYPRPTLPPYMTPIEPQVGKFYNSPVALGAGAGAVLTVPIAALGAKLNT
AA.ASV192	TTHYLFIVVVAVNSTLRTINAGDYIFYTDWAWTSFVVFSISQSTMLAVGAIYYMLFTGVPGTATYYATIMTIYTWVGGTLIGLSLPMFNMINLLLIRDPLEVAFKYPRPTLPPYMTPIEPQVGKFYNSPVALGSGAGAVLTVPIAALGAKLNT
AA.ASV193	TTHYLFIVVVAVNSTLSTINAGDYIFYTDWAWTSFVVFSISQSTMLVVGAIYYMLFTGVPGTATYYATIMTIYTWVGGTLVGLSLPIFNMINLLLVRDPLEMAFKYPRPTLPPYMTPIEPQVGKFYNSPVALGSGAGAVLSVPIAALGAKLNT
AA.ASV194	TTHYLFIVVVAVNSTLSTINAGDYIFYTDWAWTSFVVFSISQSTMLVVGAIYYMLFTGVPGTATYYATIMTIYTWVGGTLVGMSLPVFNMINLLLVRDPLEMAFKYPRPTLPPYMTPIEPQVGKFYNSPVALGAGAGAVLCVPIAALGAKLNT
AA.ASV195	TTHYLFIVVVPVNSTLLTINAGDYVFYTDWAWTSFVVFSISQSTMLVVGAIYYMLFTGVPGTATYYATIMTIYTWVGGTLVGLSLPIFNMINLLLVRDPLEMAFKYPRPTLPPYMTPIEPQVGKFYNSPVALGSGAGAVLSVPIAALGAKLNT
AA.ASV196	TTHYLFIVVVSVTLPFFPLPSGDYIFYTDWAWTSFVVFSISQSTMLVVGAICYMLFTGVPGTATYYATIMTIYTWVGGTLVGLSLPIFNMINLLLVRDPLEMAFKYPRPTLPPYMTPIEPQVGKFYNSPVALGSGAGAVLSVPIAALGAKLNT
AA.ASV197	TTHYLFLVVVAVNSTLLTINAGDYIFYTDWAWTSFVVFSISQSTMLAVGAIYYMLFTGVPGTATHYATIMTIYTWVGGTLVGLSLPMFNMINLLLVRDPLEVAFKYPRPTLPPYMTPIEPQVGKFYNSPVALGAGAGAVLTVPIAALGAKLNT
AA.ASV198	TTHYLFLVVVAVNSTLLTINAGDYIFYTDWAWTSFVVFSISQSTMLVVGAIYYMLFTGVPGTATYYATIMTIYTWVGGTLVGLSLPIFNMINLLLVRDPLEMAFKYPRPTLPPYMTPIEPQVGKFYNSPVALGSGAGAVLSVPIAALGAKLNT
AA.ASV199	TTHYLFLVVVAVNSTLLTINAGDYIFYTDWAWTSFVVFSVSQSTMLVVGAIYYMLFTGVPGTATYYATIMTIYTWVGGTLVGLSLPIFNMINLLLVRDPLEVAFKYPRPTLPPYMTPIEPQVGKFYNSPVALGSGAGAVLSVPIAALGAKLNT
AA.ASV200	TTHYLFLVVVAVNSTLLTINAGDYIFYTDWQWTSFVVFSISQSTMLAVGAVYYMLFTGVPGTATYYATIMTIYTWVGGTLVGLSFPLFNMVNLLLIRDPLEVAFKYPRPTLPAYMTPIEPQVGKFYNSPVALGSGAGAVLTVPMTALGAKLNT
AA.ASV201	TTHYLFTVVVAVNSTLLTINAGDYIFYTDWAWTSFVVFSISQSTMLTVGAIYYMLFTGVPGTATYYATIMTIYTWVGGTLVGLSLPIFNMINLLLVRDPLEMAFKYPRPTLPPYMTPIEPQVGKFYNSPVALGSGAGAVLSVPIAALGAKLNT