AA.ASV1	HYPINFVFPSAMIPGALVMDTVLLLTRNWMITALVGGGAFGLLFYPGNWTIFGPTHLPLVAEGVLLSVADYTGFLYVRTGTPEYVRLIEQGSLRTFGGHTTVIAAFFSAFVSMLMFTVWWYFGKVYCTAFYYVKGARGRVSMKNDVTAFG
AA.ASV2	HYPINFVFPSAMIPGALVMDTVMLLTRNWMITALVGGGAFGLLFYPGNWPIFGPTHLPLVAEGVLLSVADYTGFLYVRTGTPEYVRLIEQGSLRTFGGHTTVIAAFFSAFVSMLMFCVWWYFGKVYCTAFYYVKGARGRVSMKNDVTAFG
AA.ASV3	HYPINFVFPSTMIPGALAMDTVMLLTRNWMITALFGGGAFGLLFYPGNWPIFGPTHLPLVAEGVLLSLADYTGFLYVRTGTPEYVRLIEQGSLRTFGGHTTVIAAFFSAFVSMLMFCVWWYFGKLYCTAFYYVKGPRGRVTMKNDVTAYG
AA.ASV4	HYPINFVFPSTMIPGALIMDTVLLLTRNWMITALVGGGAFGLLFYPGNWPIFGPTHLPLVAEGVLLSLADYTGFLYVRTDTPEYVRLIEQGSLRTFGGHTTVIAAFFSAFVSMLMFCVWWYFGKLYCTAFYYVKGPRGRVTMKNDVTAYG
AA.ASV5	HYPINFVFPSTMIPGALIMDTVLLLTRNWMITALVGGGAFGLLFYPGNWPIFGPTHLPLVAEGVLLSLADYTGFLYVRTGTPEYVRLIEQGSLRTFGGHTTVIAAFFSAFVSMLMFCLWWYFGKLYCTAFFYVKGARGRVTMKNDVTAFG
AA.ASV6	HYPINFVFPSTMIPGALIMDTVLLLTRNWMITALVGGGAFGLLFYPGNWPIFGPTHLPLVAEGVLLSLADYTGFLYVRTGTPEYVRLIEQGSLRTFGGHTTVIAAFFSAFVSMLMFCVWWYFGKIYCTAFFYVKGPRGRVSMKNDVTAYG
AA.ASV7	HYPINFVFPSTMIPGALIMDTVLLLTRNWMITALVGGGAFGLLFYPGNWPIFGPTHLPLVAEGVLLSLADYTGFLYVRTGTPEYVRLIEQGSLRTFGGHTTVIAAFFSAFVSMLMFCVWWYFGKLYCTAFFYVKGARGRVTMKNDVTAFG
AA.ASV8	HYPINFVFPSTMIPGALIMDTVLLLTRNWMITALVGGGAFGLLFYPGNWPIFGPTHLPLVAEGVLLSLADYTGFLYVRTGTPEYVRLIEQGSLRTFGGHTTVIAAFFSAFVSMLMFCVWWYFGKLYCTAFFYVKGPRGRVTMKNDVTAYG
AA.ASV9	HYPINFVFPSTMIPGALIMDTVLLLTRNWMITALVGGGAFGLLFYPGNWPIFGPTHLPLVAEGVLLSLADYTGFLYVRTGTPEYVRLIEQGSLRTFGGHTTVIAAFFSAFVSMLMFCVWWYFGKLYCTAFYYVKGARGRVSMKNDVTAFG
AA.ASV10	HYPINFVFPSTMIPGALIMDTVLLLTRNWMITALVGGGAFGLLFYPGNWPIFGPTHLPLVAEGVLLSLADYTGFLYVRTGTPEYVRLIEQGSLRTFGGHTTVIAAFFSAFVSMLMFCVWWYFGKLYCTAFYYVKGARGRVSMQNDVTAFG
AA.ASV11	HYPINFVFPSTMIPGALIMDTVLLLTRNWMITALVGGGAFGLLFYPGNWPIFGPTHLPLVAEGVLLSLADYTGFLYVRTGTPEYVRLIEQGSLRTFGGHTTVIAAFFSAFVSMLMFCVWWYFGKLYCTAFYYVKGARGRVTMKNDVTAFG
AA.ASV12	HYPINFVFPSTMIPGALIMDTVLLLTRNWMITALVGGGAFGLLFYPGNWPIFGPTHLPLVAEGVLLSLADYTGFLYVRTGTPEYVRLIEQGSLRTFGGHTTVIAAFFSAFVSMLMFCVWWYFGKLYCTAFYYVKGPRGRVSMKNDVTAYG
AA.ASV13	HYPINFVFPSTMIPGALIMDTVLLLTRNWMITALVGGGAFGLLFYPGNWPIFGPTHLPLVAEGVLLSLADYTGFLYVRTGTPEYVRLIEQGSLRTFGGHTTVIAAFFSAFVSMLMFCVWWYFGKLYCTAFYYVKGPRGRVTMKNDVTAFG
AA.ASV14	HYPINFVFPSTMIPGALIMDTVLLLTRNWMITALVGGGAFGLLFYPGNWPIFGPTHLPLVAEGVLLSLADYTGFLYVRTGTPEYVRLIEQGSLRTFGGHTTVIAAFFSAFVSMLMFCVWWYFGKLYCTAFYYVKGPRGRVTMKNDVTAYG
AA.ASV15	HYPINFVFPSTMIPGALIMDTVLLLTRNWMITALVGGGAFGLLFYPGNWPIFGPTHLPLVAEGVLLSLADYTGFLYVRTGTPEYVRLIEQGSLRTFGGHTTVIAAFFSAFVSMLMFCVWWYFGKVYCTAFYYVKGARGRVSMKNDVTAFG
AA.ASV16	HYPINFVFPSTMIPGALIMDTVLLLTRNWMITALVGGGAFGLLFYPGNWPIFGPTHLPLVAEGVLLSLADYTGFLYVRTGTPEYVRLIEQGSLRTFGGHTTVIAAFFSAFVSMLMFTLWWYFGKLYCTAFFYVKGARGRVTMKNDVTAFG
AA.ASV17	HYPINFVFPSTMIPGALIMDTVLLLTRNWMITALVGGGAFGLLFYPGNWPIFGPTHLPLVAEGVLLSLADYTGFLYVRTGTPEYVRLIEQGSLRTFGGHTTVIAAFFSAFVSMLMFTVWWYFGKVYCTAFFYVKGARGRISMQNDVTAYG
AA.ASV18	HYPINFVFPSTMIPGALIMDTVLLLTRNWMITALVGGGAFGLLFYPGNWPIFGPTHLPLVAEGVLLSLADYTGFLYVRTGTPEYVRLIEQGSLRTFGGHTTVIAAFFSAFVSMLMFTVWWYFGKVYCTAFYYVKGARGRVSMQNDVTAFG
AA.ASV19	HYPINFVFPSTMIPGALIMDTVLLLTRNWMITALVGGGAFGLLFYPGNWPIFGPTHLPLVAEGVLLSVADYTGFLYVRTGTPEYVRNIEQGSLRTFGGHTTVIASFFAAFVSMLMFCLWWYFGKLYCTAFFYVKGARGRVTMKNDVTAFG
AA.ASV20	HYPINFVFPSTMIPGALIMDTVLLLTRNWMITALVGGGAFGLLFYPGNWPIFGPTHLPMVAEGVLLSLADYTGFLYVRTGTPEYVRLIEQGSLRTFGGHTTVIAAFFSAFVSMLMFCVWWYFGKLYCTAFYYVKGPRGRVTMKNDVTAYG
AA.ASV21	HYPINFVFPSTMIPGALIMDTVLLLTRNWMITALVGGGAFGLLFYPGNWPIFGPTHLPMVAEGVLLSLADYTGFLYVRTGTPEYVRLIEQGSLRTFGGHTTVIAAFFSAFVSMLMFTVWWYFGKVYCTAFFYVKGARGRISMQNDVTAYG
AA.ASV22	HYPINFVFPSTMIPGALIMDTVMLLTRNWMITALVGGGAFGLLFYPGNWPIFGPTHLPLVAEGVLLLVADYTGFLYVRTGTPEYVRLIEQGSLRTFGGHTTVIAAFFSAFVSMLMFCVWWYFGKVYCTAFYYVKGARGRVSMKNDVTAFG
AA.ASV23	HYPINFVFPSTMIPGALIMDTVMLLTRNWMITALVGGGAFGLLFYPGNWPIFGPTHLPLVAEGVLLSVADYTGFLYVRTGTPEYVRLIEQGSLRTFGGHTTVIAAFFAAFVSMLMFCVWWYFGKLYCTAFYYVKGPRGRVTMKNDVTAYG
AA.ASV24	HYPINFVFPSTMIPGALIMDTVMLLTRNWMITALVGGGAFGLLFYPGNWPIFGPTHLPLVAEGVLLSVADYTGFLYVRTGTPEYVRLIEQGSLRTFGGHTTVIAAFFSAFVSMLMFCLWWYFGKLYCTALFYVKGARGRVTMKNDVTAFG
AA.ASV25	HYPINFVFPSTMIPGALIMDTVMLLTRNWMITALVGGGAFGLLFYPGNWPIFGPTHLPLVAEGVLLSVADYTGFLYVRTGTPEYVRLIEQGSLRTFGGHTTVIAAFFSAFVSMLMFCVWWYFGKVYCTAFYYVKGARGRVSMKNDVTAFG
AA.ASV26	HYPINFVFPSTMIPGALIMDTVMLLTRNWMITALVGGGAFGLLFYPGNWPIFGPTHLPLVAEGVLLSVADYTGFLYVRTGTPEYVRLIEQGSLRTFGGHTTVIAAFFSAFVSMLMFTVWWYFGKVYCTAFFYVKGPRGRVSMKNDVTAYG
AA.ASV27	HYPINFVFPSTMIPGALIMDTVMLLTRNWMITALVGGGAFGLLFYPGNWPIFGPTHLPLVAEGVLLSVADYTGFLYVRTGTPEYVRNIEQGSLRTFGGHTTVIASFFAAFVSMLMFCLWWYFGKLYCTAFFYVKGARGRVTMKNDVTAFG
AA.ASV28	HYPINFVFPSTMIPGALIMDTVMLLTRNWMITALVGGGAFGLLFYPGNWPIFGPTHLPLVAEGVLLSVADYTGFLYVRTGTPEYVRNIEQGSLRTFGGHTTVIASFFAAFVSMLMFCVWWYFGKIYCTAFFYVKGPRGRVSMKNDVTAYG
AA.ASV29	HYPINFVFPSTMIPGALIMDTVMLLTRNWMITALVGGGAFGLLFYPGNWTIFGPTHLPLVAEGVLLSVADYTGFLYVRTGTPEYVRLIEQGSLRTFGGHTTVIAAFFSAFVSMLMFTVWWYFGKVYCTAFYYVKGARGRVSMKNDVTAFG
AA.ASV30	HYPINFVFPSTMIPGALIMDTVMLLTRNWMITALVGGGAFGLLFYPGNWTIFGPTHLPLVAEGVLLSVADYTGFLYVRTGTPEYVRQIEQGSLRTFGGHTTVIAAFFSAFISMLMFTVWWYFGKVYCTAFYYVKGARGRVSMQNDVTAFG
AA.ASV31	HYPINFVFPSTMIPGALIVDTVLLLTRNWMITALVGGGAFGLLFYPGNWPIFGPTHLPLVAEGVLLSVADYTGFLYVRTGTPEYVRLIEQGSLRTFGGHTTVIAAFFSAFVSMLMFTVWWYFGKVYCTAFYYVKGARGRVSMQNDVTAFG
AA.ASV32	HYPINFVFPSTMIPGALVMDTVLLLTRNWMITALIGGGAFGLLFYPGNWPIFGPTHLPLVAEGVLLSVADYTGFLYVRTGTPEYVRLIEQGSLRTFGGHTTVIAAFFSAFVSMLMFTVWWYFGKVYCTAFFYVKGPRGRISMKNDVTAYG
AA.ASV33	HYPINFVFPSTMIPGALVMDTVLLLTRNWMITALIGGGAFGLLFYPGNWPIFGPTHLPLVAEGVLLSVADYTGFLYVRTGTPEYVRLIEQGSLRTFGGHTTVIAAFFSAFVSMLMFTVWWYFGKVYCTAFFYVKGPRGRIYMKNDVTAYG
AA.ASV34	HYPINFVFPSTMIPGALVMDTVLLLTRNWMITALVGGGAFGLLFYPGNWPIFGPTHLPLVAEGVLLSLADYTGFLYVRTGTPEYVRLIEQGSLRTFGGHTTVIAAFFSAFVSMLMFCVWWYFGKLYCTAFYYVKGPRGRVTMKNDVTAYG
AA.ASV35	HYPINFVFPSTMIPGALVMDTVLLLTRNWMITALVGGGAFGLLFYPGNWPIFGPTHLPLVAEGVLLSVADYTGFLYVRTGTPEYVRNIEQGSLRTFGGHTTVIASFFAAFVSMLMFCLWWYFGKLYCTAFFYVKGARGRVTMKNDVTAFG
AA.ASV36	HYPINFVFPSTMIPGALVMDTVLLLTRNWMITALVGGGAFGLLFYPGNWTIFGPTHLPLVAEGVLLSLADYTGFLYVRTGTPEYVRLIEQGSLRTFGGHTTVIAAFFSAFVSMLMFCVWWYFGKIYCTAFFYVKGPRGRVSMKNDVTAYG
AA.ASV37	HYPINFVFPSTMIPGALVMDTVLLLTRNWMITALVGGGAFGLLFYPGNWTIFGPTHLPLVAEGVLLSVADYTGFLYVRTGTPEYVRLIEQGSLRTFGGHTTVIAAFFSAFVSMLMFCVWWYFGKVYCTAFYYVKGARGRVSMKNDVTAFG
AA.ASV38	HYPINFVFPSTMIPGALVMDTVLLLTRNWMITALVGGGAFGLLFYPGNWTIFGPTHLPLVAEGVLLSVADYTGFLYVRTGTPEYVRQIEQGSLRTFGGHTTVIAAFFSAFISMLMFTVWWYFGKVYCTAFYYVKGARGRVSMQNDVTAFG
AA.ASV39	HYPINFVFPSTMIPGALVMDTVLLLTRNWMITALVGGGAYGLLFYPGNWTIFGPTHLPLVAEGVLLSVADYTGFLYVRTGTPEYVRLIEQGSLRTFGGHTTVIASFFSAFVSMLMFTVWWYFGKLYCTAFFYVKGARGRVTMKNDVTAFG
AA.ASV40	HYPINFVFPSTMIPGALVMDTVLLLTRNWMITALVGGGAYGLLFYPGNWTIFGPTHLPLVAEGVLLSVADYTGFLYVRTGTPEYVRLIEQGSLRTFGGHTTVIASFFSAFVSMLMFTVWWYFGKVYCTAFYYVKGARGRVSMQNDVTAFG
AA.ASV41	HYPINFVFPSTMIPGALVMDTVLLLTRNWMVTALIGGGAFGLLFYPGNWPIFGPTHLPLVAEGVLLLLADYTGFLYVRTGTPEYVRLIEQGSLRTFGGHTTVIAAFFSAFVSMLMFCVWWYFGKVYCTAFYYVKGARGRVSMKNDVTAFG
AA.ASV42	HYPINFVFPSTMIPGALVMDTVLLLTRNWMVTALIGGGAFGLLFYPGNWPIFGPTHLPLVAEGVLLLVADYTGFLYVRTGTPEYVRLIEQGSLRTFGGHTTVIAAFFSAFVSMLMFCVWWYFGKVYCTAFYYVKGARGRVSMKNDVTAFG
AA.ASV43	HYPINFVFPSTMIPGALVMDTVLLLTRNWMVTALIGGGAFGLLFYPGNWPIFGPTHLPLVAEGVLLSLADYTGFLYVRTGTPEYVRLIEQGSFRTFGGHTTVIAAFFSAFVSMLMFCVWWYFGKVYCTAFYYVKGARGRVSMKNDVTAFG
AA.ASV44	HYPINFVFPSTMIPGALVMDTVLLLTRNWMVTALIGGGAFGLLFYPGNWPIFGPTHLPLVAEGVLLSLADYTGFLYVRTGTPEYVRLIEQGSLRTFGGHTTVIAAFFSAFVSMLMFCVWWYFGKVYCTAFYYVKGARGRVSMKNDVTAFG
AA.ASV45	HYPINFVFPSTMIPGALVMDTVLLLTRNWMVTALIGGGAFGLLFYPGNWPIFGPTHLPLVAEGVLLSLADYTGFLYVRTGTPEYVRLIEQGSLRTFGGHTTVIVAFFSAFVSMLMFCVWWYFGKVYCTAFYYVKGARGRVSMQNDVTAFG
AA.ASV46	HYPINFVFPSTMIPGALVMDTVLLLTRNWMVTALIGGGAFGLLFYPGNWPIFGPTHLPLVAEGVLLSVADYTGFLYVRTGTPEYVRLIEQGSLRTFGGHTTVIAAFFSAFVSMLMFCVWWYFGKVYCTAFYYVKGARGRVSMKNDVTAFG
AA.ASV47	HYPINFVFPSTMIPGALVMDTVLLLTRNWMVTALIGGGAFGLLFYPGNWPIFGPTHLPLVAEGVLLSVADYTGFLYVRTGTPEYVRNIEQGSLRTFGGHTTVIASFFAAFVSMLMFCLWWYFGKLYCTAFFYVKGARGRVTMKNDVTAFG
AA.ASV48	HYPINFVFPSTMIPGALVMDTVLLLTRNWMVTALIGGGAFGLLFYPGNWTIFGPTHLPLVAEGVLLSVADYTGFLYVRTGTPEYVRQIEQGSLRTFGGHTTVIAAFFSAFISMLMFTVWWYFGKVYCTAFYYVKGARGRVSMQNDVTAFG
AA.ASV49	HYPINFVFPSTMIPGALVMDTVMLLTRNWMITALFGGGAFGLLFYPGNWPIFGPTHLPLVAEGVLLSLADYTGFLYVRTGTPEYVRLIEQGSLRTFGGHTTVIAAFFSAFVSMLMFCVWWYFGKLYCTAFYYVKGPRGRVTMKNDVTAYG
AA.ASV50	HYPINFVFPSTMIPGALVMDTVMLLTRNWMITALFGGGAFGLLFYPGNWPIFGPTHLPLVAEGVLLSLADYTGFLYVRTGTPEYVRLIEQGSLRTFGGHTTVIAAFFSAFVSMLMFCVWWYFGKVYCTAFYYVKGARGRVSMKNDVTAFG
AA.ASV51	HYPINFVFPSTMIPGALVMDTVMLLTRNWMITALFGGGAFGLLFYPGNWPIFGPTHLPLVAEGVLLSLADYTGFLYVRTGTPEYVRLIEQGSLRTFGGHTTVIAAFFSAFVSMLMFTLWWYFGKLYCTAFFYVKGARGRVTMKNDVTAFG
AA.ASV52	HYPINFVFPSTMIPGALVMDTVMLLTRNWMITALFGGGAFGLLFYPGNWPIFGPTHLPLVAEGVLLSLADYTGFLYVRTGTPEYVRLIEQGSLRTFGGHTTVIAAFFSAFVSMLMFTVWWYFGKIYCTAFFYVKGPRGRVSMKNDVTAYG
AA.ASV53	HYPINFVFPSTMIPGALVMDTVMLLTRNWMITALFGGGAFGLLFYPGNWPIFGPTHLPLVAEGVLLSLADYTGFLYVRTGTPEYVRLIEQGSLRTFGGHTTVIAAFFSAFVSMLMFTVWWYFGKLYCTAFFYVKGARGRVTMKNDVTAFG
AA.ASV54	HYPINFVFPSTMIPGALVMDTVMLLTRNWMITALFGGGAFGLLFYPGNWPIFGPTHLPLVAEGVLLSLADYTGFLYVRTGTPEYVRLIEQGSLRTFGGHTTVIAAFFSAFVSMLMFTVWWYFGKLYCTAFYYVKGPRGRVTMKNDVTAYG
AA.ASV55	HYPINFVFPSTMIPGALVMDTVMLLTRNWMITALFGGGAFGLLFYPGNWPIFGPTHLPLVAEGVLLSLADYTGFLYVRTGTPEYVRLIEQGSLRTFGGHTTVIAAFFSAFVSMLMFTVWWYFGKVYCTAFFYVKGARGRISMQNDVTAYG
AA.ASV56	HYPINFVFPSTMIPGALVMDTVMLLTRNWMITALFGGGAFGLLFYPGNWPIFGPTHLPLVAEGVLLSLADYTGFLYVRTGTPEYVRLIEQGSLRTFGGHTTVIAAFFSAFVSMLMFTVWWYFGKVYCTAFFYVKGARGRVSMKNDVTAFG
AA.ASV57	HYPINFVFPSTMIPGALVMDTVMLLTRNWMITALFGGGAFGLLFYPGNWPIFGPTHLPLVAEGVLLSLADYTGFLYVRTGTPEYVRLIEQGSLRTFGGHTTVIAAFFSAFVSMLMFTVWWYFGKVYCTAFFYVKGARGRVTMKNDVTAFG
AA.ASV58	HYPINFVFPSTMIPGALVMDTVMLLTRNWMITALFGGGAFGLLFYPGNWPIFGPTHLPLVAEGVLLSLADYTGFLYVRTGTPEYVRLIEQGSLRTFGGHTTVIAAFFSAFVSMLMFTVWWYFGKVYCTAFFYVKGPRGRVSMKNDVTAYG
AA.ASV59	HYPINFVFPSTMIPGALVMDTVMLLTRNWMITALFGGGAFGLLFYPGNWPIFGPTHLPLVAEGVLLSLADYTGFLYVRTGTPEYVRLIEQGSLRTFGGHTTVIAAFFSAFVSMLMFTVWWYFGKVYCTAFYYVKGARGRVSMQNDVTAFG
AA.ASV60	HYPINFVFPSTMIPGALVMDTVMLLTRNWMITALFGGGAFGLLFYPGNWPIFGPTHLPLVAEGVLLSLADYTGFLYVRTGTPEYVRLIEQGSLRTLGGHTTVIAAFFAAFVSMLMFTLWWYFGKLYCTAFFYVKGARGRVTMKNDVTAFG
AA.ASV61	HYPINFVFPSTMIPGALVMDTVMLLTRNWMITALFGGGAFGLLFYPGNWPIFGPTHLPLVAEGVLLSLADYTGFLYVRTGTPEYVRNIEQGSLRTFGGHTTVIAAFFAAFVSMLMFTLWWYFGKVYCTAFFYVKGARGRISMQNDVTAYG
AA.ASV62	HYPINFVFPSTMIPGALVMDTVMLLTRNWMITALFGGGAFGLLFYPGNWPIFGPTHLPLVAEGVLLSVADYTGFLYVRTGTPEYVRLIEQGSLRTFGGHTTVIAAFFSAFVSMLMFTVWWYFGKVYCTAFFYVKGARGRVSMQNDVTAYG
AA.ASV63	HYPINFVFPSTMIPGALVMDTVMLLTRNWMITALFGGGAFGLLFYPGNWPIFGPTHLPLVAEGVLLSVADYTGFLYVRTGTPEYVRLIEQGSLRTFGGHTTVIAAFFSAFVSMLMFTVWWYFGKVYCTAFFYVKGARGRVTMQNDVTAYG
AA.ASV64	HYPINFVFPSTMIPGALVMDTVMLLTRNWMITALFGGGAFGLLFYPGNWPIFGPTHLPLVAEGVLLSVADYTGFLYVRTGTPEYVRNIEQGSLRTFGGHTTVIAAFFAAFVSMLMFTLWWYFGKLYCTAFFYVKGARGRVTMKNDVTAFG
AA.ASV65	HYPINFVFPSTMIPGALVMDTVMLLTRNWMITALFGGGAFGLLFYPGNWPIFGPTHLPLVAEGVLLSVADYTGFLYVRTGTPEYVRNIEQGSLRTFGGHTTVIASFFAAFVSMLMFCLWWYFGKLYCTAFFYVKGARGRVTMKNDVTAFG
AA.ASV66	HYPINFVFPSTMIPGALVMDTVMLLTRNWMITALIGGGAFGLLFYPGNWPIFGPTHLPLVAEGVLLSVADYTGFLYVRTGTPEYVRLIEQGSLRTFGGHTTVIAAFFSAFVSMLMFCVWWYFGKVYCTAFYYVKGARGRVSMKNDVTAFG
AA.ASV67	HYPINFVFPSTMIPGALVMDTVMLLTRNWMITALIGGGAFGLLFYPGNWPIFGPTHLPLVAEGVLLSVADYTGFLYVRTGTPEYVRLIEQGSLRTFGGHTTVIAAFFSAFVSMLMFTVWWYFGKVYCTAFFYVKGARGRVSMKNDVTAFG
AA.ASV68	HYPINFVFPSTMIPGALVMDTVMLLTRNWMITALIGGGAFGLLFYPGNWPIFGPTHLPLVAEGVLLSVADYTGFLYVRTGTPEYVRLIEQGSLRTFGGHTTVIAAFFSAFVSMLMFTVWWYFGKVYCTAFFYVKGARGRVSMQNDVTAYG
AA.ASV69	HYPINFVFPSTMIPGALVMDTVMLLTRNWMITALIGGGAFGLLFYPGNWPIFGPTHLPLVAEGVLLSVADYTGFLYVRTGTPEYVRLIEQGSLRTFGGHTTVIAAFFSAFVSMLMFTVWWYFGKVYCTAFFYVKGPRGRISMKNDVTAYG
AA.ASV70	HYPINFVFPSTMIPGALVMDTVMLLTRNWMITALIGGGAFGLLFYPGNWPIFGPTHLPLVAEGVLLSVADYTGFLYVRTGTPEYVRLIEQGSLRTFGGHTTVIAAFFSAFVSMLMFTVWWYFGKVYCTAFFYVKGPRGRIYMKNDVTAYG
AA.ASV71	HYPINFVFPSTMIPGALVMDTVMLLTRNWMITALIGGGAFGLLFYPGNWPIFGPTHLPLVAEGVLLSVADYTGFLYVRTGTPEYVRLIEQGSLRTFGGHTTVIAAFFSAFVSMLMFTVWWYFGKVYCTAFFYVKGPRGRVSMKNDVTAYG
AA.ASV72	HYPINFVFPSTMIPGALVMDTVMLLTRNWMITALIGGGAFGLLFYPGNWPIFGPTHLPLVAEGVLLSVADYTGFLYVRTGTPEYVRLIEQGSLRTFGGHTTVIAAFFSAFVSMLMFTVWWYFGKVYCTAFYYVKGARGRVSMKNDVTAFG
AA.ASV73	HYPINFVFPSTMIPGALVMDTVMLLTRNWMITALIGGGAFGLLFYPGNWPIFGPTHLPLVAEGVLLSVADYTGFLYVRTGTPEYVRLIEQGSLRTFGGHTTVIAAFFSAFVSMLMFTVWWYFGKVYCTAFYYVKGPRGRISMKNDVTAYG
AA.ASV74	HYPINFVFPSTMIPGALVMDTVMLLTRNWMITALIGGGAFGLLFYPGNWPIFGPTHLPLVAEGVLLSVADYTGFLYVRTGTPEYVRNIEQGSLRTFGGHTTVIASFFAAFVSMLMFCLWWYFGKLYCTAFFYVKGARGRVTMKNDVTAFG
AA.ASV75	HYPINFVFPSTMIPGALVMDTVMLLTRNWMITALVDGGAHGLLFYPGNWTIFGPTHLPLVAEGVLLSVADYTGFLYVRTGTPEYVRLIEQGSLRTFGGHTTVIAAFFSAFVSMLMFTVWWYFGKVYCTAFYYVKGARGRVSMQNDVTAFG
AA.ASV76	HYPINFVFPSTMIPGALVMDTVMLLTRNWMITALVGGGAFGLLFYPGNWPIFGPTHLPLVAEGVLLLVADYTGFLYVRTGTPEYVRQIEQGSLRTFGGHTTVIAAFFSAFISMLMFTVWWYFGKVYCTAFYYVKGARGRVSMQNDVTAFG
AA.ASV77	HYPINFVFPSTMIPGALVMDTVMLLTRNWMITALVGGGAFGLLFYPGNWPIFGPTHLPLVAEGVLLSLADYTGFLYVRTGTPEYVRLIEQGSLRTFGGHTTVIAAFFSAFVSMLMFCVWWYFGKIYCTAFFYVKGPRGRVSMKNDVTAYG
AA.ASV78	HYPINFVFPSTMIPGALVMDTVMLLTRNWMITALVGGGAFGLLFYPGNWPIFGPTHLPLVAEGVLLSLADYTGFLYVRTGTPEYVRLIEQGSLRTFGGHTTVIAAFFSAFVSMLMFCVWWYFGKIYCTAFYYVKGPRGRVSMKNDVTAYG
AA.ASV79	HYPINFVFPSTMIPGALVMDTVMLLTRNWMITALVGGGAFGLLFYPGNWPIFGPTHLPLVAEGVLLSLADYTGFLYVRTGTPEYVRLIEQGSLRTFGGHTTVIAAFFSAFVSMLMFCVWWYFGKLYCTAFYYVKGPRGRVTMKNDVTAYG
AA.ASV80	HYPINFVFPSTMIPGALVMDTVMLLTRNWMITALVGGGAFGLLFYPGNWPIFGPTHLPLVAEGVLLSLADYTGFLYVRTGTPEYVRLIEQGSLRTFGGHTTVIAAFFSAFVSMLMFCVWWYFGKVYCTAFYYVKGARGRVSMKNDVTAFG
AA.ASV81	HYPINFVFPSTMIPGALVMDTVMLLTRNWMITALVGGGAFGLLFYPGNWPIFGPTHLPLVAEGVLLSLADYTGFLYVRTGTPEYVRLIEQGSLRTFGGHTTVIASFFAAFVSMLMFTVWWYFGKLYCSAFFYVKGARGRVTMKNDVTAFG
AA.ASV82	HYPINFVFPSTMIPGALVMDTVMLLTRNWMITALVGGGAFGLLFYPGNWPIFGPTHLPLVAEGVLLSVADYTGFLYVRTGTPEYVRLIEQGSLRTFGGHTTVIAAFFSAFVSMLMFCVWWYFGKIYCTAFFYVKGPRGRISMKNDVTAYG
AA.ASV83	HYPINFVFPSTMIPGALVMDTVMLLTRNWMITALVGGGAFGLLFYPGNWPIFGPTHLPLVAEGVLLSVADYTGFLYVRTGTPEYVRLIEQGSLRTFGGHTTVIAAFFSAFVSMLMFCVWWYFGKIYCTAFYYVKGPRGRISMKNDVTAYG
AA.ASV84	HYPINFVFPSTMIPGALVMDTVMLLTRNWMITALVGGGAFGLLFYPGNWPIFGPTHLPLVAEGVLLSVADYTGFLYVRTGTPEYVRLIEQGSLRTFGGHTTVIAAFFSAFVSMLMFCVWWYFGKVYCTAFYYVKGARGRVSMKNDVTAFG
AA.ASV85	HYPINFVFPSTMIPGALVMDTVMLLTRNWMITALVGGGAFGLLFYPGNWPIFGPTHLPLVAEGVLLSVADYTGFLYVRTGTPEYVRLIEQGSLRTFGGHTTVIAAFFSAFVSMLMFTVWWYFGKVYCTAFYYVKGARGRVSMKNDVTAFG
AA.ASV86	HYPINFVFPSTMIPGALVMDTVMLLTRNWMITALVGGGAFGLLFYPGNWPIFGPTHLPLVAEGVLLSVADYTGFLYVRTGTPEYVRLIEQGSLRTFGGHTTVIAAFFSAFVSMLMFTVWWYFGKVYCTAFYYVKGPRGRISMKNDVTAYG
AA.ASV87	HYPINFVFPSTMIPGALVMDTVMLLTRNWMITALVGGGAFGLLFYPGNWPIFGPTHLPLVAEGVLLSVADYTGFLYVRTGTPEYVRNIEQGSLRTFGGHTTVIASFFAAFVSMLMFCLWWYFGKLYCTAFFYVKGARGRVTMKNDVTAFG
AA.ASV88	HYPINFVFPSTMIPGALVMDTVMLLTRNWMITALVGGGAFGLLFYPGNWTIFGPTHLPLVAEGVLLSVADYTGFLYVRTGTPEYVRLIEQGSLRTFGGHTTVIAAFFSAFVSMLMFTVWWYFGKVYCTAFYYVKGARGRVSMINDVTAFG
AA.ASV89	HYPINFVFPSTMIPGALVMDTVMLLTRNWMITALVGGGAFGLLFYPGNWTIFGPTHLPLVAEGVLLSVADYTGFLYVRTGTPEYVRLIEQGSLRTFGGHTTVIAAFFSAFVSMLMFTVWWYFGKVYCTAFYYVKGARGRVSMQNDVTAFG
AA.ASV90	HYPINFVFPSTMIPGALVMDTVMLLTRNWMITALVGGGAYGLLFYPGNWTIFGPTHLPLVAEGVLLLVADYTGFLYVRTGTPEYVRLIEQGSLRTFGGHTTVIAAFFSAFVSMLMFTVWWYFGKVYCTAFYYVKGARGRVSMQNDVTAFG
AA.ASV91	HYPINFVFPSTMIPGALVMDTVMLLTRNWMITALVGGGAYGLLFYPGNWTIFGPTHLPLVAEGVLLSVADYTGFLYVRTGTPEYVRLIEQGSLRTFGGHTTVIAAFFSAFVSMLMFTVWWYFGKVYCTAFYYVKGARGRVSMQNDVTAFG
AA.ASV92	HYPINFVFPSTMIPGALVMDTVMLLTRNWMITALVGGGAYGLLFYPGNWTIFGPTHLPLVAEGVLLSVADYTGFLYVRTGTPEYVRNIEQGSLRTFGGHTTVIAAFFAAFVSMLMFTLWWYFGKLYCTAFFYVKGARGRVTMKNDVTAFG
AA.ASV93	HYPINFVFPSTMIPGALVMDTVMLLTRNWMITALVGGGAYGLLFYPGNWTIFGPTHLPLVAEGVLLSVADYTGFLYVRTGTPEYVRNIEQGSLRTFGGHTTVIASFFAAFVSMLMFCLWWYFGKLYCTAFFYVKGARGRVTMKNDVTAFG
AA.ASV94	HYPINFVFPSTMIPGALVMDTVMLLTRNWMVTALIGGGAFGLLFYPGNWPIFGPTHLPLVAEGVLLSLADYTGFLYVRTGTPEYVRLIEQGSLRTFGGHTTVIAAFFSAFVSMLMFCVWWYFGKVYCTAFYYVKGARGRVSMKNDVTAFG
AA.ASV95	HYPINFVFPSTMIPGAPVMDTVMLLTRNWMITALVGGGAFGLLFYPGNWPIFGPTHLPLVAEGVLLFVADYTGFLYVRTGTPEYVRNIEQGSLRTFGGHTTVIASFFAAFVSMLMFCLWWYFGKLYCTAFFYVKGARGRVTMKNDVTAFG
AA.ASV96	HYPINFVFPSTTIPGALVMDTVMLLTRNWMITALVGGGAFGLLFYPGNWPIFGPTHLPLVAEGVLLSLADYTGFLYVRTGTPEYVRLIEQGSLRTFGGHTTVIAAFFSAFVSMLMFCVWWYFGKIYCTAFFYVKGPRGRVSMKNDVTAYG
AA.ASV97	HYPINFVLPSAMIPGALVMDTVLLLTRNWMVTALIGGGAFGLLFYPGNWTIFGPTHLPLVAEGVLLSVADYTGFLYVRTGTPEYVRQIEQGSLRTFGGHTTVIAAFFSAFISMLMFTVWWYFGKVYCTAFYYVKGARGRVSMQNDVTAFG
AA.ASV98	HYPINFVLPSTMIPGALAMDTVMLLTRNWMITALVGGGAFGLLFYPGNWPIFGPTHLPLVAEGVLLSLADYTGFLYVRTGTPEYVRLIEQGSLRTFGGHTTVIAAFFSAFVSMLMFCVWWYFGKLYCTAFYYVKGPRGRVTMKNDVTAYG
AA.ASV99	HYPINFVLPSTMIPGALIMDTVMLLTRNWMITALVGGGAFGLLFYPGNWPIFGPTHLPLVAEGVLLSLADYTGFLYVRTGTPEYVRLIEQGSLRTFGGHTTVIAAFFSAFVSMLMFCVWWYFGKLYCTAFYYVKGPRGRVTMKNDVTAYG
AA.ASV100	HYPINFVLPSTMIPGALIMDTVMLLTRNWMITALVGGGAFGLLFYPGNWTIFGPTHLPLVAEGVLLLVADYTGFLYVRTGTPEYVRLIEQGSLRTFGGHTTVIAAFFSAFVSMLMFTVWWYFGKVYCTAFYYVKGARGRVSMINDVTAFG
AA.ASV101	HYPINFVLPSTMIPGALMLDTIMLLTGNWLVTALLGGGFFGLLFYPGNWPIFGPTHLPVVVEGVLLSVADYTGFLYVRTGTPEYVRLIEQGSLRTFGGHTTVIAAFFAAFVSMLMFCVWWYFGKLYCTAFYYVKGERGRISMKYDVTAFG
AA.ASV102	HYPINFVLPSTMIPGALVMDTVLLLTRNWMATALIGGGAFGLLFYPGNWPIFGPTHLPLVAEGVLLSLADYTGFLYVRTGTPEYVRLIEQGSLRTFGGHTTVIAAFFSAFVSMLMFCVWWYFGKVYCTAFYYVKGARGRVSMKNDVTAFG
AA.ASV103	HYPINFVLPSTMIPGALVMDTVLLLTRNWMITALVGGGAFGLLFYPGNWTIFGPTHLPLVAEGVLLSVADYTGFLYVRTGTPEYVRQIEQGSLRTFGGHTTVIAAFFSAFISMLMFTVWWYFGKVYCTAFYYVKGARGRVSMQNDVTAFG
AA.ASV104	HYPINFVLPSTMIPGALVMDTVLLLTRNWMVTALIGGGAFGLLFYPGNWPIFGPTHLPLVAEGVLLLLADYTGFLYVRTGTPEYVRLIEQGSLRTFGGHTTVIAAFFSAFVSMLMFCVWWYFGKVYCTAFYYVKGARGRVSMKNDVTAFG
AA.ASV105	HYPINFVLPSTMIPGALVMDTVLLLTRNWMVTALIGGGAFGLLFYPGNWPIFGPTHLPLVAEGVLLSLADYTGFLYVRTGTPEYVRLIEQGSLRTFGGHTTVIAAFFSAFVSMLMFCVWWYFGKLYCTAFYYVKGPRGRVTMKNDVTAFG
AA.ASV106	HYPINFVLPSTMIPGALVMDTVLLLTRNWMVTALIGGGAFGLLFYPGNWPIFGPTHLPLVAEGVLLSLADYTGFLYVRTGTPEYVRLIEQGSLRTFGGHTTVIAAFFSAFVSMLMFCVWWYFGKVYCTAFYYVKGARGRVSMKNDVTAFG
AA.ASV107	HYPINFVLPSTMIPGALVMDTVLLLTRNWMVTALIGGGAFGLLFYPGNWPIFGPTHLPLVAEGVLLSLADYTGFLYVRTGTPEYVRLIEQGSLRTFGGHTTVIAAFFSAFVSMLMFTVWWYFGKVYCTAFFYVKGPRGRISMKNDVTAYG
AA.ASV108	HYPINFVLPSTMIPGALVMDTVLLLTRNWMVTALIGGGAFGLLFYPGNWPIFGPTHLPLVAEGVLLSLADYTGFLYVRTGTPEYVRLIEQGSLRTFGGHTTVIAAFFSAFVSTLMFTVWWYFGKVYCTAFYYVKGARGRVSMKNDVTAFG
AA.ASV109	HYPINFVLPSTMIPGALVMDTVLLLTRNWMVTALIGGGAFGLLFYPGNWPIFGPTHLPLVAEGVLLSVADYTGFLYVRTGTPEYVRNIEQGSLRTFGGHTTVIASFFAAFVSMLMFCLWWYFGKLYCTAFFYVKGARGRVTMKNDVTAFG
AA.ASV110	HYPINFVLPSTMIPGALVMDTVMLLTRNWMITALVGGGAFGLLFYPGNWPIFGPTHLPLVAEGVLLSLADYTGFLYVRTGTPEYVRLIEQGSLRTFGGHTTMIAAFFAAFVSMLMFCVWWYFGKLYCTAFYYVKGPRGRVTMKNDVTAYG
AA.ASV111	HYPINFVLPSTMIPGALVMDTVMLLTRNWMITALVGGGAFGLLFYPGNWPIFGPTHLPLVAEGVLLSLADYTGFLYVRTGTPEYVRLIEQGSLRTFGGHTTVIAAFFAAFVSMLMFCVWWYFGKLYCTAFYYVKGPRGRVTMKNDVTAYG
AA.ASV112	HYPINFVLPSTMIPGALVMDTVMLLTRNWMITALVGGGAFGLLFYPGNWPIFGPTHLPLVAEGVLLSLADYTGFLYVRTGTPEYVRLIEQGSLRTFGGHTTVIAAFFSAFVSMLMFCVWWYFGKIYCTAFYYVKGPRGRVSMKNDVTAYG
AA.ASV113	HYPINFVLPSTMIPGALVMDTVMLLTRNWMITALVGGGAFGLLFYPGNWPIFGPTHLPLVAEGVLLSLADYTGFLYVRTGTPEYVRLIEQGSLRTFGGHTTVIAAFFSAFVSMLMFCVWWYFGKLYCTAFYYVKGPRGRVTMKNDVTAYG
AA.ASV114	HYPINFVLPSTMIPGALVMDTVMLLTRNWMITALVGGGAFGLLFYPGNWPIFGPTHLPLVAEGVLLSLADYTGFLYVRTGTPEYVRLIEQGSLRTFGGHTTVIAAFFSAFVSMLMFCVWWYFGKVYCTAFYYVKGARGRVSMKNDVTAFG
AA.ASV115	HYPINFVLPSTMIPGALVMDTVMLLTRNWMITALVGGGAFGLLFYPGNWPIFGPTHLPLVAEGVLLSVADYTGFLYVRTGTPEYVRLIEQGSLRTFGGHTTVIAAFFSAFVSMLMFCVWWYFGKVYCTAFYYVKGARGRVSMKNDVTAFG
AA.ASV116	HYPINFVLPSTMIPGALVMDTVMLLTRNWMITALVGGGAFGLLFYPGNWTIFGPTHLPLVAEGVLLSLADYTGFLYVRTGTPEYVRLIEQGSLRTFGGHTTVIAAFFSAFVSMLMFCVWWYFGKLYCTAFYYVKGPRGRVTMKNDVTAYG
AA.ASV117	HYPISFVFPSAMIPGALVMDTVMLLTRNWMITALVGGGAFGLLFYPGNWPIFGPTHLPLVAEGVLLSVADYTGFLYVRTGTPEYVRLIEQGSLRTFGGHTTVIAAFFSAFVSMLMFTVWWYFGKVYCTAFYYVKGARGRVSMQNDVTAFG
AA.ASV118	HYPISFVFPSTMIPGALVMDTLMLLTRNWMITALVGGGAFGLLFYPGNWPIFGPTHLPLVAEGVLLSVADYTGFLYVRTGTPEYVRNIEQGSLRTFGGHTTVIASFFAAFVSMLMFCLWWYFGKLYCTAFFYVKGARGRVTMKNDVTAFG
AA.ASV119	HYPISFVFPSTMIPGALVMDTVLLLTRNWMITALVGGGAFGLLFYPGNWPIFGPTHLPLVAEGVLLSVADYTGFLYVRTGTPEYVRLIEQGSLRTFGGHTTVIAAFFSAFVSMLMFCVWWYFGKVYCTAFYYVKGARGRVSMKNDVTAFG
AA.ASV120	HYPISFVFPSTMIPGALVMDTVLLLTRNWMITALVGGGAFGLLFYPGNWTIFGPTHLPLVAEGVLLSVADYTGFLYVRTGTPEYVRQIEQGSLRTFGGHTTVIAAFFSAFISMLMFTVWWYFGKVYCTAFYYVKGARGRVSMQNDVTAFG
AA.ASV121	HYPISFVFPSTMIPGALVMDTVMLLTRNWMITALFGGGAFGLLFYPGNWPIFGPTHLPLVAEGVLLSLADYTGFLYVRTGTPEYVRLIEQGSLRTFGGHTTVIAAFFSAFVSMLMFTVWWYFGKVYCTAFFYVKGARGRISMQNDVTAYG
AA.ASV122	HYPISFVFPSTMIPGALVMDTVMLLTRNWMITALVGGGAFGLLFYPGDWTIFGPTHLPLVAEGVLLSVADYTGFLYVRTGTPEYVRLIEQGSLRTFGGHTTVIAAFFSAFVSMLMFTVWWYFGKVYCTAFYYVKGARGRVSMKNDVTAFG
AA.ASV123	HYPISFVFPSTMIPGALVMDTVMLLTRNWMITALVGGGAFGLLFYPGNWPIFGPTHLPLVAEGVLLSLADYTGFLYVRTGTPEYVRLIEQGSLRTFGGHTTVIAAFFSAFVSMLMFCVWWYFGKLYCTAFYYVKGPRGRVTMKNDVTAYG
AA.ASV124	HYPISFVFPSTMIPGALVMDTVMLLTRNWMITALVGGGAFGLLFYPGNWPIFGPTHLPLVAEGVLLSVADYTGFLYVRTGTPEYVRLIEQGSLRTFGGHTTVIASFFAAFVSMLMFCVWWYFGKVYCTAFYYVKGARGRVSMKNDVTAFG
AA.ASV125	HYPISFVFPSTMIPGALVMDTVMLLTRNWMITALVGGGAFGLLFYPGNWPIFGPTHLPLVAEGVLLSVADYTGFLYVRTGTPEYVRLIEQGSLRTFGGHTTVIASFFAAFVSMLMFSVWWYFGKLYCTAFFYVKGARGRVTMKNDVTAFG
AA.ASV126	HYPISFVFPSTMIPGALVMDTVMLLTRNWMITALVGGGAFGLLFYPGNWPIFGPTHLPLVAEGVLLSVADYTGFLYVRTGTPEYVRLIEQGSLRTFGGHTTVIASFFAAFVSMLMFTVWWYFGKLYCSAFFYVKGARGRVTMKNDVTAFG
AA.ASV127	HYPISFVFPSTMIPGALVMDTVMLLTRNWMITALVGGGAFGLLFYPGNWPIFGPTHLPLVAEGVLLSVADYTGFLYVRTGTPEYVRLIEQGSLRTFGGHTTVIASFFAAFVSMLMFTVWWYLGKFYCTAFFYVKGARGRVTMKNDVTAFG
AA.ASV128	HYPISFVFPSTMIPGALVMDTVMLLTRNWMITALVGGGAFGLLFYPGNWPIFGPTHLPLVAEGVLLSVADYTGFLYVRTGTPEYVRNIEQGSLRTFGGHTTIIAAFFSAFVSMLMFTVWWYFGKVYCTAFFYVKGARGRVSMQNDVTAYG
AA.ASV129	HYPISFVFPSTMIPGALVMDTVMLLTRNWMITALVGGGAFGLLFYPGNWPIFGPTHLPLVAEGVLLSVADYTGFLYVRTGTPEYVRNIEQGSLRTFGGHTTVIAAFFAAFVSMLMFTLWWYFGKLYCTAFFYVKGARGRVTMKNDVTAFG
AA.ASV130	HYPISFVFPSTMIPGALVMDTVMLLTRNWMITALVGGGAFGLLFYPGNWPIFGPTHLPLVAEGVLLSVADYTGFLYVRTGTPEYVRNIEQGSLRTFGGHTTVIAAFFSAFVSMLMFCVWWYFGKIYCTAFFYVKGPRGRVSMKNDVTAYG
AA.ASV131	HYPISFVFPSTMIPGALVMDTVMLLTRNWMITALVGGGAFGLLFYPGNWPIFGPTHLPLVAEGVLLSVADYTGFLYVRTGTPEYVRNIEQGSLRTFGGHTTVIAAFFSAFVSMLMFCVWWYFGKLYCTAFYYVKGPRGRVTMKNDVTAYG
AA.ASV132	HYPISFVFPSTMIPGALVMDTVMLLTRNWMITALVGGGAFGLLFYPGNWPIFGPTHLPLVAEGVLLSVADYTGFLYVRTGTPEYVRNIEQGSLRTFGGHTTVIAAFFSAFVSMLMFCVWWYFGKVYCTAFYYVKGARGRVSMKNDVTAFG
AA.ASV133	HYPISFVFPSTMIPGALVMDTVMLLTRNWMITALVGGGAFGLLFYPGNWPIFGPTHLPLVAEGVLLSVADYTGFLYVRTGTPEYVRNIEQGSLRTFGGHTTVIASFFAAFVSMLMFCLWWYFGKLYCTAFFYVKGARGRVTMKNDVTAFG
AA.ASV134	HYPISFVFPSTMIPGALVMDTVMLLTRNWMITALVGGGAFGLLFYPGNWPIFGPTHLPLVAEGVLLSVADYTGFLYVRTGTPEYVRNIEQGSLRTFGGHTTVIASFFAAFVSMLMFCLWWYFGKLYCTAFFYVKGPRGRVSMKNDVTAYG
AA.ASV135	HYPISFVFPSTMIPGALVMDTVMLLTRNWMITALVGGGAFGLLFYPGNWPIFGPTHLPLVAEGVLLSVADYTGFLYVRTGTPEYVRNIEQGSLRTFGGHTTVIASFFAAFVSMLMFCLWWYFGKLYCTAFYYVKGARGRVSMKNDVTAFG
AA.ASV136	HYPISFVFPSTMIPGALVMDTVMLLTRNWMITALVGGGAFGLLFYPGNWPIFGPTHLPLVAEGVLLSVADYTGFLYVRTGTPEYVRNIEQGSLRTFGGHTTVIASFFAAFVSMLMFCLWWYFGKVYCTAFYYVKGARGRVSMQNDVTAFG
AA.ASV137	HYPISFVFPSTMIPGALVMDTVMLLTRNWMITALVGGGAFGLLFYPGNWPIFGPTHLPLVAEGVLLSVADYTGFLYVRTGTPEYVRNIEQGSLRTFGGHTTVIASFFAAFVSMLMFCVWWYFGKIYCTAFFYVKGPRGRVSMKNDVTAYG
AA.ASV138	HYPISFVFPSTMIPGALVMDTVMLLTRNWMITALVGGGAFGLLFYPGNWPIFGPTHLPLVAEGVLLSVADYTGFLYVRTGTPEYVRNIEQGSLRTFGGHTTVIASFFAAFVSMLMFCVWWYFGKVYCTAFYYVKGARGRVSMKNDVTAFG
AA.ASV139	HYPISFVFPSTMIPGALVMDTVMLLTRNWMITALVGGGAFGLLFYPGNWPIFGPTHLPLVAEGVLLSVADYTGFLYVRTGTPEYVRNIEQGSLRTFGGHTTVIASFFAAFVSMLMFTLWWYFGKLYCTAFFYVKGARGRVTMKNDVTAFG
AA.ASV140	HYPISFVFPSTMIPGALVMDTVMLLTRNWMITALVGGGAFGLLFYPGNWPIFGPTHLPLVAEGVLLSVADYTGFLYVRTGTPEYVRNIEQGSLRTFGGHTTVIASFFAAFVSMLMFTVWWYFGKVYCTAFFYVKGARGRISMQNDVTAYG
AA.ASV141	HYPISFVFPSTMIPGALVMDTVMLLTRNWMITALVGGGAFGLLFYPGNWPIFGPTHLPLVAEGVLLSVADYTGFLYVRTGTPEYVRNIEQGSLRTFGGHTTVIASFFAAFVSMLMFTVWWYFGKVYCTAFYYVKGARGRVSMQNDVTAFG
AA.ASV142	HYPISFVFPSTMIPGALVMDTVMLLTRNWMITALVGGGAFGLLFYPGNWPIFGPTHLPLVVEGVLLSVADYTGFLYVRTGTPEYVRNIEQGSLRTFGGHTTVIAAFFAAFISMLMFCIWWYFGKLYCTAFFYVKGHRGRVTMKNDVTAFG
AA.ASV143	HYPISFVFPSTMIPGALVMDTVMLLTRNWMITALVGGGAFGLLFYPGNWTIFGPTHLPLVAEGVLLSVADYTGFLYVRTGTPEYVRLIEQGSLRTFGGHTTVIAAFFSAFVSMLMFTVWWYFGKVYCTAFYYVKGARGRVSMKNDVTAFG
AA.ASV144	HYPISFVFPSTMIPGALVMDTVMLLTRNWMITALVGGGAFGLLFYPGNWTIFGPTHLPLVAEGVLLSVADYTGFLYVRTGTPEYVRQIEQGSLRTFGGHTTVIAAFFSAFISMLMFTVWWYFGKVYCTAFYYVKGARGRVSMQNDVTAFG
AA.ASV145	HYPISLVFPSTMIPGALVMDTVMLLTRNWMITALVGGGAFGLLFYPGNWTIFGPTHLPLVAEGVLLSVADYTGFLYVRTGTPEYVRLIEQGSLRTFGGHTTVIASFFSAFVSMLMFTVWWYFGKVYCTAFYYVKGARGRVSMQNDVTAFG
AA.ASV146	HYPMNFVFPSAMIPGALVMDTVLLLTRNWMITALVGGGAFGLLFYPGNWPIFGPTHLPLVAEGVLLSLADYTGFLYVRTGTPEYVRLIEQGSLRTFGGHTTVIAAFFSAFVSMLMFCVWWYFGKVYCTAFYYVKGARGRVSMKNDVTAFG
AA.ASV147	HYPMNFVFPSTMIPGALVMDTVLLLTRNWMITALVGGGAFGLLFYPGNWPIFGPTHLPLVAEGVLLSLADYTGFLYVRTGTPEYVRLIEQGSLRTFGGHTTVIAAFFSAFVSMLMFCVWWYFGKLYCTAFYYVKGPRGRVTMKNDVTAYG
AA.ASV148	HYPMNFVFPSTMIPGALVMDTVLLLTRNWMITALVGGGAFGLLFYPGNWPIFGPTHLPLVAEGVLLSLADYTGFLYVRTGTPEYVRLIEQGSLRTFGGHTTVIAAFFSAFVSMLMFCVWWYFGKVYCTAFYYVKGARGRVSMKNDVTAFG
AA.ASV149	HYPMNFVFPSTMIPGALVMDTVLLLTRNWMITALVGGGAFGLLFYPGNWPIFGPTHLPLVAEGVLLSVADYTGFLYVRTGTPEYVRNIEQGSLRTFGGHTTVIAAFFAAFVSMLMFTLWWYFGKLYCTAFFYVKGARGRVTMKNDVTAFG
AA.ASV150	HYPMNFVFPSTMIPGALVMDTVLLLTRNWMITALVGGGAFGLLFYPGNWPIFGPTHLPLVAEGVLLSVADYTGFLYVRTGTPEYVRNIEQGSLRTFGGHTTVIASFFAAFVSMLMFCLWWYFGKLYCTAFFYVKGARGRVTMKNDVTAFG
AA.ASV151	HYPMNFVFPSTMIPGALVMDTVLLLTRNWMITALVGGGAFGLLFYPGNWTIFGPTHLPLVAEGVLLLVADYTGFLYVRTGTPEYVRQIEQGSLRTFGGHTTVIAAFFSAFISMLMFTVWWYFGKVYCTAFYYVKGARGRVSMQNDVTAFG
AA.ASV152	HYPMNFVFPSTMIPGALVMDTVLLLTRNWMITALVGGGAFGLLFYPGNWTIFGPTHLPLVAEGVLLSVADYTGFLYVRTGTPEYVRLIEQGSLRTFGGHTTVIAAFFSAFVSMLMFTVWWYFGKVYCTAFYYVKGARGRVSMQNDVTAFG
AA.ASV153	HYPMNFVFPSTMIPGALVMDTVLLLTRNWMITALVGGGAFGLLFYPGNWTIFGPTHLPLVAEGVLLSVADYTGFLYVRTGTPEYVRNIEQGSLRTFGGHTTVIAAFFAAFVSMLMFTLWWYFGKLYCTAFFYVKGARGRVTMKNDVTAFG
AA.ASV154	HYPMNFVFPSTMIPGALVMDTVLLLTRNWMITALVGGGAFGLLFYPGNWTIFGPTHLPLVAEGVLLSVADYTGFLYVRTGTPEYVRQIEQGSLRTFGGHTTVIAAFFAAFVSMLMFTLWWYFGKLYCTAFFYVKGARGRVTMKNDVTAYG
AA.ASV155	HYPMNFVFPSTMIPGALVMDTVLLLTRNWMITALVGGGAFGLLFYPGNWTIFGPTHLPLVAEGVLLSVADYTGFLYVRTGTPEYVRQIEQGSLRTFGGHTTVIAAFFSAFISMLMFTVWWYFGKVYCTAFFYVKGPRGRISMKNDVTAYG
AA.ASV156	HYPMNFVFPSTMIPGALVMDTVLLLTRNWMITALVGGGAFGLLFYPGNWTIFGPTHLPLVAEGVLLSVADYTGFLYVRTGTPEYVRQIEQGSLRTFGGHTTVIAAFFSAFISMLMFTVWWYFGKVYCTAFFYVKGPRGRVSMKNDVTAYG
AA.ASV157	HYPMNFVFPSTMIPGALVMDTVLLLTRNWMITALVGGGAFGLLFYPGNWTIFGPTHLPLVAEGVLLSVADYTGFLYVRTGTPEYVRQIEQGSLRTFGGHTTVIAAFFSAFISMLMFTVWWYFGKVYCTAFYYVKGARGRVSMKNDVTAFG
AA.ASV158	HYPMNFVFPSTMIPGALVMDTVLLLTRNWMITALVGGGAFGLLFYPGNWTIFGPTHLPLVAEGVLLSVADYTGFLYVRTGTPEYVRQIEQGSLRTFGGHTTVIAAFFSAFISMLMFTVWWYFGKVYCTAFYYVKGARGRVSMQNDVTAFG
AA.ASV159	HYPMNFVFPSTMIPGALVMDTVLLLTRNWMITALVGGGAFGLLFYPGNWTIFGPTHLPLVAEGVLLSVADYTGFLYVRTGTPEYVRQIEQGSLRTFGGHTTVIAAFFSAFVSMLMFCVWWYFGKLYCTAFYYVKGPRGRVTMKNDVTAYG
AA.ASV160	HYPMNFVFPSTMIPGALVMDTVLLLTRNWMITALVGSGAFGLLFYPGNWTIFGPTHLPLVAEGVLLSVADYTGFLYVRTGTPEYVRQIEQGSLRTFGGHTTVIAAFFSAFISMLMFTVWWYFGKVYCTAFYYVKGARGRVSMQNDVTAFG
AA.ASV161	HYPMNFVFPSTMIPGALVMDTVLLLTRNWMVTALIGGGAFGLLFYPGNWPIFGPTHLPLVAEGVLLSVADYTGFLYVRTGTPEYVRLIEQGSLRTFGGHTTVIAAFFSAFVSMLMFTVWWYFGKVYCTAFYYVKGARGRVSMQNDVTAFG
AA.ASV162	HYPMNFVFPSTMIPGALVMDTVLLLTRNWMVTALIGGGAFGLLFYPGNWTIFGPTHLPLVAEGVLLSVADYTGFLYVRTGTPEYVRLIEQGSLRTFGGHTTVIAAFFSAFVSMLMFTVWWYFGKVYCTAFYYVKGARGRVSMKNDVTAFG
AA.ASV163	HYPMNFVFPSTMIPGALVMDTVLLPTRNWMITALVGGGAFGLLFYPGNWPIFGPTHLPLVAEGVLLSVADYTGFLYVRTGTPEYVRNIEQGSLRTFGGHTTVIAAFFAAFVSMLMFTLWWYFGKLYCTAFFYVKGARGRVTMKNDVTAFG
AA.ASV164	HYPMNFVFPSTMIPGALVMDTVLLPTRNWMITALVGGGAFGLLFYPGNWPIFGPTHLPLVAEGVLLSVADYTGFLYVRTGTPEYVRNIEQGSLRTFGGHTTVIASFFAAFVSMLMFCLWWYFGKLYCTAFFYVKGARGRVTMKNDVTAFG
AA.ASV165	HYPMNFVFPSTMIPGALVMDTVMLLTRNWMITALVGGGAFGLLFYPDNWTIFGPTHLPLVAEGVLLSVADYTGFLYVRTGTPEYVRLIEQGSLRTFGGHTTVIAAFFSAFVSMLMFTVWWYFGKVYCTAFYYVKGARGRVSMINDVTAFG
AA.ASV166	HYPMNFVFPSTMIPGALVMDTVMLLTRNWMITALVGGGAFGLLFYPGNWPIFDPTHLPLVAEGVLLSVADYTGFLYVRTGTPEYVRNIEQGSLRTFGGHTTVIASFFAAFVSMLMFCLWWYFGKLYCTAFFYVKGARGRVTMKNDVTAFG
AA.ASV167	HYPMNFVFPSTMIPGALVMDTVMLLTRNWMITALVGGGAFGLLFYPGNWPIFGPTHLPLVAEGVLLSLADYTGFLYVRTGTPEYVRLIEQGSLRTFGGHTTVIAAFFSAFVSMLMFCVWWYFGKVYCTAFYYVKGARGRVSMKNDVTAFG
AA.ASV168	HYPMNFVFPSTMIPGALVMDTVMLLTRNWMITALVGGGAFGLLFYPGNWPIFGPTHLPLVAEGVLLSVADYTGFLYVRTGTPEYVRLIEQGSLRTFGGHTTVIAAFFSAFVSMLMFCVWWYFGKVYCTAFYYVKGARGRVSMKNDVTAFG
AA.ASV169	HYPMNFVFPSTMIPGALVMDTVMLLTRNWMITALVGGGAFGLLFYPGNWPIFGPTHLPLVAEGVLLSVADYTGFLYVRTGTPEYVRLIEQGSLRTFGGHTTVIAAFFSAFVSMLMFTVWWYFGKVYCTAFFYVKGPRGRVSMKNDVTAYG
AA.ASV170	HYPMNFVFPSTMIPGALVMDTVMLLTRNWMITALVGGGAFGLLFYPGNWPIFGPTHLPLVAEGVLLSVADYTGFLYVRTGTPEYVRNIEQGSLRTFGGHTTVIASFFAAFVSMLMFCLWWYFGKLYCTAFFYVKGARGRVTMKNDVTAFG
AA.ASV171	HYPMNFVFPSTMIPGALVMDTVMLLTRNWMITALVGGGAFGLLFYPGNWTIFGPTHLPLVAEGVLLLVADYTGFLYVRTGTPEYVRLIEQGSLRTFGGHTTVIAAFFSAFVSMLMFTVWWYFGKVYCTAFYYVKGARGRVSMINDVTAFG
AA.ASV172	HYPMNFVFPSTMIPGALVMDTVMLLTRNWMITALVGGGAFGLLFYPGNWTIFGPTHLPLVAEGVLLSVADYTGFLYVRTGTPEYVRLIEQGSLRTFGGHTTVIAAFFAAFVSMLMFCVWWYFGKLYCTAFYYVKGPRGRVTMKNDVTAFG
AA.ASV173	HYPMNFVFPSTMIPGALVMDTVMLLTRNWMITALVGGGAFGLLFYPGNWTIFGPTHLPLVAEGVLLSVADYTGFLYVRTGTPEYVRLIEQGSLRTFGGHTTVIAAFFAAFVSMLMFTVWWYFGKVYCTAFYYVKGARGRVSMKNDVTAFG
AA.ASV174	HYPMNFVFPSTMIPGALVMDTVMLLTRNWMITALVGGGAFGLLFYPGNWTIFGPTHLPLVAEGVLLSVADYTGFLYVRTGTPEYVRLIEQGSLRTFGGHTTVIAAFFSAFVSMLMFCLWWYFGKLYCTAFFYVKGARGHVTMKNDVTAFG
AA.ASV175	HYPMNFVFPSTMIPGALVMDTVMLLTRNWMITALVGGGAFGLLFYPGNWTIFGPTHLPLVAEGVLLSVADYTGFLYVRTGTPEYVRLIEQGSLRTFGGHTTVIAAFFSAFVSMLMFCVWWYFGKIYCTAFFYVKGPRGRVSMKNDVTAYG
AA.ASV176	HYPMNFVFPSTMIPGALVMDTVMLLTRNWMITALVGGGAFGLLFYPGNWTIFGPTHLPLVAEGVLLSVADYTGFLYVRTGTPEYVRLIEQGSLRTFGGHTTVIAAFFSAFVSMLMFCVWWYFGKLYCTAFYYVKGPRGRVTMKNDVTAYG
AA.ASV177	HYPMNFVFPSTMIPGALVMDTVMLLTRNWMITALVGGGAFGLLFYPGNWTIFGPTHLPLVAEGVLLSVADYTGFLYVRTGTPEYVRLIEQGSLRTFGGHTTVIAAFFSAFVSMLMFCVWWYFGKVYCTAFYYVKGARGRVSMKNDVTAFG
AA.ASV178	HYPMNFVFPSTMIPGALVMDTVMLLTRNWMITALVGGGAFGLLFYPGNWTIFGPTHLPLVAEGVLLSVADYTGFLYVRTGTPEYVRLIEQGSLRTFGGHTTVIAAFFSAFVSMLMFTVWWYFGKVYCTAFFYVKGPRGRVSMKNDVTAYG
AA.ASV179	HYPMNFVFPSTMIPGALVMDTVMLLTRNWMITALVGGGAFGLLFYPGNWTIFGPTHLPLVAEGVLLSVADYTGFLYVRTGTPEYVRLIEQGSLRTFGGHTTVIAAFFSAFVSMLMFTVWWYFGKVYCTAFYYVKGARGRVSMINDVTAFG
AA.ASV180	HYPMNFVFPSTMIPGALVMDTVMLLTRNWMITALVGGGAFGLLFYPGNWTIFGPTHLPLVAEGVLLSVADYTGFLYVRTGTPEYVRLIEQGSLRTFGGHTTVIAAFFSAFVSMLMFTVWWYFGKVYCTAFYYVKGARGRVSMKNDVTAFG
AA.ASV181	HYPMNFVFPSTMIPGALVMDTVMLLTRNWMITALVGGGAFGLLFYPGNWTIFGPTHLPLVAEGVLLSVADYTGFLYVRTGTPEYVRLIEQGSLRTFGGHTTVIAAFFSAFVSMLMFTVWWYFGKVYCTAFYYVKGARGRVSMQNDVTAFG
AA.ASV182	HYPMNFVFPSTMIPGALVMDTVMLLTRNWMITALVGGGAFGLLFYPGNWTIFGPTHLPLVAEGVLLSVADYTGFLYVRTGTPEYVRLIEQGSLRTFGGHTTVIAAFFSAFVSMLMFTVWWYFGKVYCTAFYYVKGARGRVSMVNDVTAFG
AA.ASV183	HYPMNFVFPSTMIPGALVMDTVMLLTRNWMITALVGGGAFGLLFYPGNWTIFGPTHLPLVAEGVLLSVADYTGFLYVRTGTPEYVRLIEQGSLRTFGGHTTVIAAFFSAFVSMLMFTVWWYFGKVYCTAFYYVKGPRGRVSTKNDVTAYG
AA.ASV184	HYPMNFVFPSTMIPGALVMDTVMLLTRNWMITALVGGGAFGLLFYPGNWTIFGPTHLPLVAEGVLLSVADYTGFLYVRTGTPEYVRLIEQGSLRTFGGHTTVTAAFFSAFVSMLMFCVWWYFGKVYCTAFYYVKGARGRVSMKNDVTAFG
AA.ASV185	HYPMNFVFPSTMIPGALVMDTVMLLTRNWMITALVGGGAFGLLFYPGNWTIFGPTHLPLVAEGVLLSVADYTGFLYVRTGTPEYVRLIEQGSLRTFGSHTTVIAAFFSAFVSMLMFTVWWYFGKIYCTAFFYVKGPRGRVSMKNDVTAYG
AA.ASV186	HYPMNFVFPSTMIPGALVMDTVMLLTRNWMITALVGGGAFGLLFYPGNWTIFGPTHLPLVAEGVLLSVADYTGFLYVRTGTPEYVRLIEQGSLRTSGGHTTVIAAFFSAFVSMLMFTVWWYFGKLYCTAFFYVKGVRGRVTMKNDVTAFG
AA.ASV187	HYPMNFVFPSTMIPGALVMDTVMLLTRNWMITALVGGGAFGLLFYPGNWTIFGPTHLPLVAEGVLLSVADYTGFLYVRTGTPEYVRNIEQGSLRTFGGHTTVIAAFFAAFVSMLMFTLWWYFGKLYCTAFFYVKGARGRVTMKNDVTAFG
AA.ASV188	HYPMNFVFPSTMIPGALVMDTVMLLTRNWMITALVGGGAFGLLFYPGNWTIFGPTHLPLVAEGVLLSVADYTGFLYVRTGTPEYVRQIEQGSLRTFGGHTTVIAAFFSAFISMLMFTVWWYFGKVYCTAFYYVKGARGRVSMQNDVTAFG
AA.ASV189	HYPMNFVFPSTMIPGALVMDTVMLLTRNWMITALVGGGAFGLLFYPGNWTIFGPTHLPLVAEGVLLSVSDYTGFLYVRTGTPEYVRLIEQGSLRTFGGHTTVIAAFFSAFVSMLMFTVWWYFGKVYCTAFYYVKGARGRVSMKNDVTAFG
AA.ASV190	HYPMNFVFPSTMIPGALVMDTVMLLTRNWMITALVGGGAFGLLFYPGNWTIFGPTHLPLVAEGVLLSVSDYTGFLYVRTGTPEYVRLIEQGSLRTFGSHTTVIAAFFSAFVSMLMFTVWWYFGKIYCTAFFYVKGPRGRVSMKNDVTAYG
AA.ASV191	HYPMNFVFPSTMNPGALVMDTVMLLTRNWMITALVGGGAFGLLFYPGNWPIFGPTHLPLVAEGVLLSLADYTGFLYVRTGTPEYVRLIEQGSLRTFGGHTTVIAAFFSAFVSMLMFCVWWYFGKLYCTAFYYVKGPRGRVTMKNDVTAYG